salt	salt	1
sugar	sugar	1
butter	butter	1
eggs	eggs	1
garlic	garlic	1
water	water	1
olive oil	olive oil	1
milk	milk	1
flour	flour	1
onion	onion	1
pepper	pepper	1
onions	onions	1
black pepper	black pepper	1
brown sugar	brown sugar	1
egg	egg	1
cinnamon	cinnamon	1
all-purpose flour	all-purpose flour	1
baking powder	baking powder	1
lemon juice	lemon juice	1
tomatoes	tomatoes	1
vanilla	vanilla	1
vanilla extract	vanilla extract	1
parsley	parsley	1
unsalted butter	unsalted butter	1
baking soda	baking soda	1
sour cream	sour cream	1
vegetable oil	vegetable oil	1
celery	celery	1
ginger	ginger	1
lemon	lemon	1
cream cheese	cream cheese	1
carrots	carrots	1
cheddar cheese	cheddar cheese	1
beef	beef	1
potatoes	potatoes	1
oil	oil	1
honey	honey	1
nutmeg	nutmeg	1
cheese	cheese	1
soy sauce	soy sauce	1
mayonnaise	mayonnaise	1
chicken broth	chicken broth	1
oregano	oregano	1
cumin	cumin	1
thyme	thyme	1
garlic powder	garlic powder	1
salt and pepper	salt and pepper	1
mushrooms	mushrooms	1
cilantro	cilantro	1
basil	basil	1
pecans	pecans	1
bacon	bacon	1
heavy cream	heavy cream	1
chicken breasts	chicken breasts	1
worcestershire sauce	worcestershire sauce	1
paprika	paprika	1
chocolate	chocolate	1
chicken	chicken	1
walnuts	walnuts	1
chili powder	chili powder	1
almonds	almonds	1
lime juice	lime juice	1
parmesan cheese	parmesan cheese	1
pineapple	pineapple	1
rice	rice	1
orange juice	orange juice	1
white sugar	white sugar	1
green pepper	green pepper	1
raisins	raisins	1
coconut	coconut	1
cayenne pepper	cayenne pepper	1
nuts	nuts	1
dijon mustard	dijon mustard	1
cornstarch	cornstarch	1
mzarella cheese	mzarella cheese	1
buttermilk	buttermilk	1
vinegar	vinegar	1
apples	apples	1
red pepper	red pepper	1
tomato sauce	tomato sauce	1
bread crumbs	bread crumbs	1
oats	oats	1
spinach	spinach	1
shortening	shortening	1
red pepper flakes	red pepper flakes	1
shallots	shallots	1
tomato paste	tomato paste	1
red bell pepper	red bell pepper	1
lime	lime	1
shrimp	shrimp	1
zucchini	zucchini	1
strawberries	strawberries	1
rosemary	rosemary	1
canola oil	canola oil	1
green onions	green onions	1
bananas	bananas	1
scallions	scallions	1
cloves	cloves	1
mustard	mustard	1
cocoa powder	cocoa powder	1
chicken stock	chicken stock	1
sea salt	sea salt	1
chives	chives	1
whipping cream	whipping cream	1
bread	bread	1
maple syrup	maple syrup	1
orange	orange	1
corn starch	corn starch	1
balsamic vinegar	balsamic vinegar	1
dry white wine	dry white wine	1
coriander	coriander	1
bay leaf	bay leaf	1
ketchup	ketchup	1
yogurt	yogurt	1
red wine vinegar	red wine vinegar	1
avocado	avocado	1
sesame oil	sesame oil	1
cabbage	cabbage	1
bay leaves	bay leaves	1
chocolate chips	chocolate chips	1
broccoli	broccoli	1
salt and black pepper	salt and black pepper	1
chicken breast	chicken breast	1
cocoa	cocoa	1
carrot	carrot	1
basil leaves	basil leaves	1
onion powder	onion powder	1
cucumber	cucumber	1
peanut butter	peanut butter	1
allspice	allspice	1
dry mustard	dry mustard	1
cranberries	cranberries	1
mint	mint	1
ham	ham	1
green bell pepper	green bell pepper	1
blueberries	blueberries	1
soda	soda	1
wheat flour	wheat flour	1
peas	peas	1
curry powder	curry powder	1
corn	corn	1
coconut milk	coconut milk	1
lettuce	lettuce	1
white pepper	white pepper	1
sesame seeds	sesame seeds	1
pork	pork	1
turmeric	turmeric	1
pasta	pasta	1
dill	dill	1
yellow onion	yellow onion	1
white wine	white wine	1
red onion	red onion	1
jalapeno chilies	jalapeno chilies	1
confectioners' sugar	confectioners ' sugar	1
cream of mushroom soup	cream of mushroom soup	1
beans	beans	1
almond extract	almond extract	1
black beans	black beans	1
garlic salt	garlic salt	1
peanuts	peanuts	1
cider vinegar	cider vinegar	1
white vinegar	white vinegar	1
margarine	margarine	1
green beans	green beans	1
cream	cream	1
molasses	molasses	1
confectioners sugar	confectioners sugar	1
pumpkin	pumpkin	1
coconut oil	coconut oil	1
sauce	sauce	1
turkey	turkey	1
yeast	yeast	1
olives	olives	1
corn syrup	corn syrup	1
sage	sage	1
rice vinegar	rice vinegar	1
raspberries	raspberries	1
beef broth	beef broth	1
salt & pepper	salt & pepper	1
ricotta cheese	ricotta cheese	1
salsa	salsa	1
tomato	tomato	1
breadcrumbs	breadcrumbs	1
spray	spray	1
cilantro leaves	cilantro leaves	1
parsley leaves	parsley leaves	1
apple cider vinegar	apple cider vinegar	1
capers	capers	1
bell pepper	bell pepper	1
gelatin	gelatin	1
green chilies	green chilies	1
black olives	black olives	1
feta cheese	feta cheese	1
swiss cheese	swiss cheese	1
cherry tomatoes	cherry tomatoes	1
potato	potato	1
oranges	oranges	1
cool whip	cool whip	1
cream of tartar	cream of tartar	1
cornmeal	cornmeal	1
pineapple juice	pineapple juice	1
italian seasoning	italian seasoning	1
cherries	cherries	1
cauliflower	cauliflower	1
white wine vinegar	white wine vinegar	1
whipped cream	whipped cream	1
caster sugar	caster sugar	1
applesauce	applesauce	1
asparagus	asparagus	1
thyme leaves	thyme leaves	1
salmon	salmon	1
cooking oil	cooking oil	1
cayenne	cayenne	1
flour tortillas	flour tortillas	1
dates	dates	1
leeks	leeks	1
purple onion	purple onion	1
green onion	green onion	1
mint leaves	mint leaves	1
dressing	dressing	1
skim milk	skim milk	1
oatmeal	oatmeal	1
mango	mango	1
graham cracker crumbs	graham cracker crumbs	1
fish sauce	fish sauce	1
peanut oil	peanut oil	1
red wine	red wine	1
cottage cheese	cottage cheese	1
salad oil	salad oil	1
heavy whipping cream	heavy whipping cream	1
tuna	tuna	1
apple	apple	1
sausage	sausage	1
vanilla ice cream	vanilla ice cream	1
cooking spray	cooking spray	1
eggplant	eggplant	1
plum tomatoes	plum tomatoes	1
tarragon	tarragon	1
thru	thru	1
peaches	peaches	1
goat cheese	goat cheese	1
ice	ice	1
kidney beans	kidney beans	1
chocolate morsels	chocolate morsels	1
can cream of chicken soup	can cream of chicken soup	1
chicken thighs	chicken thighs	1
tofu	tofu	1
corn tortillas	corn tortillas	1
chickpeas	chickpeas	1
vegetable broth	vegetable broth	1
celery seed	celery seed	1
shallot	shallot	1
clove	clove	1
chicken soup	chicken soup	1
spaghetti	spaghetti	1
lemon peel	lemon peel	1
black peppercorns	black peppercorns	1
lg. onion	lg . onion	1
yellow cake mix	yellow cake mix	1
banana	banana	1
hamburger	hamburger	1
bread flour	bread flour	1
cardamom	cardamom	1
fresh lemon juice	fresh lemon juice	1
all purpose flour	all purpose flour	1
catsup	catsup	1
dry yeast	dry yeast	1
cake flour	cake flour	1
brandy	brandy	1
salad	salad	1
horseradish	horseradish	1
vodka	vodka	1
sweet potatoes	sweet potatoes	1
beer	beer	1
coffee	coffee	1
butternut squash	butternut squash	1
half & half	half & half	1
white onion	white onion	1
smoked paprika	smoked paprika	1
apple juice	apple juice	1
chile	chile	1
pie shell	pie shell	1
pumpkin pie spice	pumpkin pie spice	1
lemons	lemons	1
vegetable stock	vegetable stock	1
egg noodles	egg noodles	1
broccoli florets	broccoli florets	1
pine nuts	pine nuts	1
sweet onion	sweet onion	1
pears	pears	1
brown rice	brown rice	1
parsley flakes	parsley flakes	1
red peppers	red peppers	1
quinoa	quinoa	1
hot pepper sauce	hot pepper sauce	1
tomato soup	tomato soup	1
dry sherry	dry sherry	1
blue cheese	blue cheese	1
07/05	7 / 5	1
arugula	arugula	1
dry red wine	dry red wine	1
corn kernels	corn kernels	1
hot sauce	hot sauce	1
green peppers	green peppers	1
cumin seed	cumin seed	1
barbecue sauce	barbecue sauce	1
artichoke hearts	artichoke hearts	1
water chestnuts	water chestnuts	1
lemon rind	lemon rind	1
chili sauce	chili sauce	1
tabasco sauce	tabasco sauce	1
beef stock	beef stock	1
orange peel	orange peel	1
marshmallows	marshmallows	1
kale	kale	1
white bread	white bread	1
vegetable shortening	vegetable shortening	1
american cheese	american cheese	1
dill weed	dill weed	1
fruit	fruit	1
white rice	white rice	1
hazelnuts	hazelnuts	1
crabmeat	crabmeat	1
pie crust	pie crust	1
beets	beets	1
almond milk	almond milk	1
marjoram	marjoram	1
baby spinach	baby spinach	1
graham crackers	graham crackers	1
prosciutto	prosciutto	1
ice cubes	ice cubes	1
fennel	fennel	1
tomato juice	tomato juice	1
half-and-half	half-and-half	1
evaporated milk	evaporated milk	1
parmesan	parmesan	1
yellow cornmeal	yellow cornmeal	1
seasoning salt	seasoning salt	1
garam masala	garam masala	1
ground pepper	ground pepper	1
pumpkin purã©e	pumpkin purã © e	1
rum	rum	1
rhubarb	rhubarb	1
jewel-osco â	jewel-osco â  	1
spinach leaves	spinach leaves	1
apple cider	apple cider	1
fennel seeds	fennel seeds	1
herbs	herbs	1
radishes	radishes	1
monterey jack cheese	monterey jack cheese	1
crisco	crisco	1
sun-dried tomatoes	sun-dried tomatoes	1
pork tenderloin	pork tenderloin	1
velveeta cheese	velveeta cheese	1
plain flour	plain flour	1
saffron	saffron	1
dark chocolate	dark chocolate	1
chuck	chuck	1
lasagna noodles	lasagna noodles	1
celery salt	celery salt	1
sunflower seeds	sunflower seeds	1
light cream	light cream	1
romaine lettuce	romaine lettuce	1
yellow bell pepper	yellow bell pepper	1
coconut flakes	coconut flakes	1
gingerroot	gingerroot	1
hoisin sauce	hoisin sauce	1
dark rum	dark rum	1
poppy seeds	poppy seeds	1
coriander seeds	coriander seeds	1
greek yogurt	greek yogurt	1
spring onions	spring onions	1
red chili peppers	red chili peppers	1
mzarella	mzarella	1
eow macaroni	eow macaroni	1
apricots	apricots	1
& black pepper	& black pepper	1
orange rind	orange rind	1
bisquick	bisquick	1
yellow squash	yellow squash	1
oregano leaves	oregano leaves	1
vanilla pudding	vanilla pudding	1
orange zest	orange zest	1
poultry seasoning	poultry seasoning	1
pistachios	pistachios	1
french bread	french bread	1
roma tomatoes	roma tomatoes	1
panko breadcrumbs	panko breadcrumbs	1
lamb	lamb	1
sage leaves	sage leaves	1
mustard seeds	mustard seeds	1
macaroni	macaroni	1
pinenuts	pinenuts	1
mini marshmallows	mini marshmallows	1
white chocolate	white chocolate	1
cucumbers	cucumbers	1
crab meat	crab meat	1
vanilla beans	vanilla beans	1
grapes	grapes	1
green olives	green olives	1
cashews	cashews	1
jalapeno pepper	jalapeno pepper	1
lettuce leaves	lettuce leaves	1
agave nectar	agave nectar	1
shredded cheese	shredded cheese	1
mushroom	mushroom	1
apricot	apricot	1
clams	clams	1
salz	salz	1
kernel corn	kernel corn	1
gruyere cheese	gruyere cheese	1
baguette	baguette	1
miniature marshmallows	miniature marshmallows	1
provolone cheese	provolone cheese	1
puff pastry	puff pastry	1
oyster sauce	oyster sauce	1
chicken wings	chicken wings	1
taco seasoning	taco seasoning	1
noodles	noodles	1
wheat germ	wheat germ	1
red food coloring	red food coloring	1
tahini	tahini	1
granny smith apples	granny smith apples	1
jalapeno peppers	jalapeno peppers	1
vanilla wafers	vanilla wafers	1
pancetta	pancetta	1
lemon extract	lemon extract	1
couscous	couscous	1
golden raisins	golden raisins	1
pepperoni	pepperoni	1
cake	cake	1
pork chops	pork chops	1
caraway seeds	caraway seeds	1
juice	juice	1
salted butter	salted butter	1
ml milk	ml milk	1
mixed vegetables	mixed vegetables	1
brussels sprouts	brussels sprouts	1
liquid smoke	liquid smoke	1
parsnips	parsnips	1
cashew nuts	cashew nuts	1
light corn syrup	light corn syrup	1
ginger root	ginger root	1
snow peas	snow peas	1
red bell peppers	red bell peppers	1
sauerkraut	sauerkraut	1
linguine	linguine	1
green peas	green peas	1
almond flour	almond flour	1
fish	fish	1
pasta sauce	pasta sauce	1
corn flakes	corn flakes	1
baby carrots	baby carrots	1
hamburger buns	hamburger buns	1
cream of celery soup	cream of celery soup	1
whip	whip	1
russet potatoes	russet potatoes	1
salad greens	salad greens	1
scallion	scallion	1
jack cheese	jack cheese	1
feta cheese crumbles	feta cheese crumbles	1
lemongrass	lemongrass	1
refried beans	refried beans	1
seasoning	seasoning	1
limes	limes	1
pinto beans	pinto beans	1
stock	stock	1
chia seeds	chia seeds	1
blackberries	blackberries	1
white chocolate chips	white chocolate chips	1
butter margarine	butter margarine	1
romano cheese	romano cheese	1
tortilla chips	tortilla chips	1
turkey breast	turkey breast	1
mushroom soup	mushroom soup	1
watercress	watercress	1
avocados	avocados	1
sweet paprika	sweet paprika	1
low sodium soy sauce	low sodium soy sauce	1
jalapeno	jalapeno	1
flank steak	flank steak	1
chocolate syrup	chocolate syrup	1
pie	pie	1
lentils	lentils	1
ice cream	ice cream	1
vanilla instant pudding	vanilla instant pudding	1
peppercorns	peppercorns	1
tabasco pepper sauce	tabasco pepper sauce	1
shredded cheddar cheese	shredded cheddar cheese	1
coconut sugar	coconut sugar	1
garbanzo beans	garbanzo beans	1
sherry vinegar	sherry vinegar	1
coconut flour	coconut flour	1
tequila	tequila	1
sherry	sherry	1
icing sugar	icing sugar	1
white flour	white flour	1
cajun seasoning	cajun seasoning	1
cheddar	cheddar	1
arborio rice	arborio rice	1
mirin	mirin	1
broth	broth	1
chilies	chilies	1
pimentos	pimentos	1
onion soup mix	onion soup mix	1
yellow mustard	yellow mustard	1
pecan	pecan	1
marinara sauce	marinara sauce	1
pumpkin seeds	pumpkin seeds	1
cake mix	cake mix	1
orange marmalade	orange marmalade	1
bourbon whiskey	bourbon whiskey	1
red potatoes	red potatoes	1
sriracha	sriracha	1
whipped topping	whipped topping	1
corn oil	corn oil	1
pfeffer	pfeffer	1
green bell peppers	green bell peppers	1
vanilla bean	vanilla bean	1
leek	leek	1
italian sausage	italian sausage	1
star anise	star anise	1
mascarpone	mascarpone	1
chili flakes	chili flakes	1
tortillas	tortillas	1
yoghurt	yoghurt	1
crackers	crackers	1
vanilla yogurt	vanilla yogurt	1
lemon pepper	lemon pepper	1
pineapple chunks	pineapple chunks	1
butterscotch chips	butterscotch chips	1
crã¨me fraã®che	crã ̈me fraã ® che	1
basmati rice	basmati rice	1
figs	figs	1
chile pepper	chile pepper	1
anchovy	anchovy	1
onion flakes	onion flakes	1
cumin seeds	cumin seeds	1
1% low-fat milk	1 % low-fat milk	1
bourbon	bourbon	1
currants	currants	1
pizza sauce	pizza sauce	1
lg. eggs	lg . eggs	1
red kidney beans	red kidney beans	1
lemonade	lemonade	1
rosemary leaves	rosemary leaves	1
club soda	club soda	1
bean sprouts	bean sprouts	1
mustard powder	mustard powder	1
maraschino cherries	maraschino cherries	1
syrup	syrup	1
apricot preserves	apricot preserves	1
lard	lard	1
milk chocolate chips	milk chocolate chips	1
okra	okra	1
white cake mix	white cake mix	1
active dry yeast	active dry yeast	1
parmigiano-reggiano cheese	parmigiano-reggiano cheese	1
ginger ale	ginger ale	1
meat	meat	1
ricotta	ricotta	1
cranberry juice	cranberry juice	1
warm water	warm water	1
chocolate cake mix	chocolate cake mix	1
instant yeast	instant yeast	1
pork loin	pork loin	1
pastry	pastry	1
plums	plums	1
ritz crackers	ritz crackers	1
graham cracker crust	graham cracker crust	1
onion salt	onion salt	1
white beans	white beans	1
monterey jack	monterey jack	1
cinnamon sticks	cinnamon sticks	1
macadamia nuts	macadamia nuts	1
mussels	mussels	1
corn flour	corn flour	1
vanilla essence	vanilla essence	1
prunes	prunes	1
tarragon leaves	tarragon leaves	1
seasoned salt	seasoned salt	1
peppermint extract	peppermint extract	1
dash pepper	dash pepper	1
instant coffee	instant coffee	1
mace	mace	1
sunflower oil	sunflower oil	1
rice krispies	rice krispies	1
red onions	red onions	1
fennel bu	fennel bu	1
plain yogurt	plain yogurt	1
chile powder	chile powder	1
jalapenos	jalapenos	1
croutons	croutons	1
bell peppers	bell peppers	1
chicken bouillon	chicken bouillon	1
sausages	sausages	1
raspberry jam	raspberry jam	1
pimento	pimento	1
rice flour	rice flour	1
xanthan gum	xanthan gum	1
pork shoulder	pork shoulder	1
tomatillos	tomatillos	1
tomato purã©e	tomato purã © e	1
vegetable oil cooking spray	vegetable oil cooking spray	1
topping	topping	1
spices	spices	1
walnut	walnut	1
berries	berries	1
tabasco	tabasco	1
caramels	caramels	1
shiitake mushrooms	shiitake mushrooms	1
enchilada sauce	enchilada sauce	1
sea scallops	sea scallops	1
coriander leaves	coriander leaves	1
milk chocolate	milk chocolate	1
chili	chili	1
almond butter	almond butter	1
vegetables	vegetables	1
sugar substitute	sugar substitute	1
tart apples	tart apples	1
pecan halves	pecan halves	1
wine vinegar	wine vinegar	1
celery ribs	celery ribs	1
ghee	ghee	1
red cabbage	red cabbage	1
cognac	cognac	1
tomato puree	tomato puree	1
dark sesame oil	dark sesame oil	1
rice wine vinegar	rice wine vinegar	1
asparagus spears	asparagus spears	1
wheat pastry flour	wheat pastry flour	1
green food coloring	green food coloring	1
teriyaki sauce	teriyaki sauce	1
prawns	prawns	1
green cabbage	green cabbage	1
salmon fillets	salmon fillets	1
grapeseed oil	grapeseed oil	1
milk powder	milk powder	1
turnips	turnips	1
almond meal	almond meal	1
cannellini beans	cannellini beans	1
chestnuts	chestnuts	1
coconut cream	coconut cream	1
condensed cream of mushroom soup	condensed cream of mushroom soup	1
old bay seasoning	old bay seasoning	1
wedges	wedges	1
egg substitute	egg substitute	1
sherry wine	sherry wine	1
spaghetti sauce	spaghetti sauce	1
penne pasta	penne pasta	1
shredded monterey jack cheese	shredded monterey jack cheese	1
button mushrooms	button mushrooms	1
simple syrup	simple syrup	1
espresso powder	espresso powder	1
fresh thyme	fresh thyme	1
pumpkin puree	pumpkin puree	1
english cucumber	english cucumber	1
pork sausage	pork sausage	1
watermelon	watermelon	1
low-fat buttermilk	low-fat buttermilk	1
popcorn	popcorn	1
half and half	half and half	1
semi-sweet chocolate chips	semi-sweet chocolate chips	1
eggplants	eggplants	1
nutritional yeast	nutritional yeast	1
chili pepper	chili pepper	1
kalamata	kalamata	1
cream style corn	cream style corn	1
x black pepper	x black pepper	1
miracle whip	miracle whip	1
cremini mushrooms	cremini mushrooms	1
flaxseed	flaxseed	1
salt and ground pepper	salt and ground pepper	1
semi-sweet chocolate morsels	semi-sweet chocolate morsels	1
11/2 baking soda	11 / 2 baking soda	1
cherry pie	cherry pie	1
chili peppers	chili peppers	1
pomegranate seeds	pomegranate seeds	1
eagle brand milk	eagle brand milk	1
g	g	1
flax seeds	flax seeds	1
gin	gin	1
pesto	pesto	1
cracker crumbs	cracker crumbs	1
creole seasoning	creole seasoning	1
mustard seed	mustard seed	1
kahlua	kahlua	1
butter oil	butter oil	1
beef brisket	beef brisket	1
crescent rolls	crescent rolls	1
coconut extract	coconut extract	1
bacon bits	bacon bits	1
peppers	peppers	1
taco seasoning mix	taco seasoning mix	1
grand marnier	grand marnier	1
dough	dough	1
pie crusts	pie crusts	1
scallops	scallops	1
red chili powder	red chili powder	1
oysters	oysters	1
chiles	chiles	1
clam juice	clam juice	1
olive oil oil	olive oil oil	1
sake	sake	1
soy milk	soy milk	1
apricot jam	apricot jam	1
cardamom pods	cardamom pods	1
chicken breast halves	chicken breast halves	1
squash	squash	1
curry leaves	curry leaves	1
lemon jello	lemon jello	1
bicarbonate of soda	bicarbonate of soda	1
rice noodles	rice noodles	1
double cream	double cream	1
food coloring	food coloring	1
cauliflower florets	cauliflower florets	1
dill pickles	dill pickles	1
biscuits	biscuits	1
fruit cocktail	fruit cocktail	1
caramel sauce	caramel sauce	1
seeds	seeds	1
frosting	frosting	1
sweet corn	sweet corn	1
vanilla bean paste	vanilla bean paste	1
minute rice	minute rice	1
curry paste	curry paste	1
vegetable cooking spray	vegetable cooking spray	1
fine sea salt	fine sea salt	1
bisquick baking mix	bisquick baking mix	1
pearl barley	pearl barley	1
golden syrup	golden syrup	1
fontina cheese	fontina cheese	1
glaze	glaze	1
chicken bouillon cubes	chicken bouillon cubes	1
pretzels	pretzels	1
sour milk	sour milk	1
brown onion	brown onion	1
chips	chips	1
cantaloupe	cantaloupe	1
sprinkles	sprinkles	1
oreo cookies	oreo cookies	1
orange bell pepper	orange bell pepper	1
white mushrooms	white mushrooms	1
beef bouillon	beef bouillon	1
velveeta	velveeta	1
orange liqueur	orange liqueur	1
filling	filling	1
gorgonzola	gorgonzola	1
triple sec	triple sec	1
brie cheese	brie cheese	1
barley	barley	1
celery soup	celery soup	1
guacamole	guacamole	1
leg of lamb	leg of lamb	1
pecorino romano cheese	pecorino romano cheese	1
reggiano cheese	reggiano cheese	1
marsala wine	marsala wine	1
veal	veal	1
cooked rice	cooked rice	1
wine	wine	1
brown mustard	brown mustard	1
lemon, juice of	lemon , juice of	1
strawberry	strawberry	1
amaretto	amaretto	1
bbq sauce	bbq sauce	1
red potato	red potato	1
kalamata olives	kalamata olives	1
flax seed meal	flax seed meal	1
sharp cheese	sharp cheese	1
pork and beans	pork and beans	1
mixed spice	mixed spice	1
english muffins	english muffins	1
acorn squash	acorn squash	1
pesto sauce	pesto sauce	1
sweet chili sauce	sweet chili sauce	1
chili beans	chili beans	1
cherry	cherry	1
polenta	polenta	1
garlic paste	garlic paste	1
reduced sodium soy sauce	reduced sodium soy sauce	1
tomatoes tomatoes	tomatoes tomatoes	1
table salt	table salt	1
el ãl	el ã  l	1
food cake	food cake	1
lime zest	lime zest	1
cane sugar	cane sugar	1
chow mein noodles	chow mein noodles	1
coriander powder	coriander powder	1
wesson oil	wesson oil	1
garlic garlic	garlic garlic	1
poppy seed	poppy seed	1
red capsicum	red capsicum	1
chard	chard	1
poblano peppers	poblano peppers	1
cornflour	cornflour	1
141/2 diced tomatoes	141 / 2 diced tomatoes	1
philadelphia cream cheese	philadelphia cream cheese	1
ml double cream	ml double cream	1
rice wine	rice wine	1
navy beans	navy beans	1
iceberg lettuce	iceberg lettuce	1
anchovies	anchovies	1
jam	jam	1
prepared horseradish	prepared horseradish	1
jicama	jicama	1
cranberry sauce	cranberry sauce	1
dry vermouth	dry vermouth	1
pineapple tidbits	pineapple tidbits	1
cracked black pepper	cracked black pepper	1
lemon juice lemon	lemon juice lemon	1
portabello mushroom	portabello mushroom	1
pomegranate juice	pomegranate juice	1
marshmallow creme	marshmallow creme	1
cheddar cheese soup	cheddar cheese soup	1
black-eyed peas	black-eyed peas	1
espresso	espresso	1
cherry pie filling	cherry pie filling	1
chicken drumsticks	chicken drumsticks	1
salt & black pepper	salt & black pepper	1
taco sauce	taco sauce	1
yellow peppers	yellow peppers	1
lemon wedges	lemon wedges	1
red curry paste	red curry paste	1
. hamburger	. hamburger	1
beansprouts	beansprouts	1
artichokes	artichokes	1
chili paste	chili paste	1
picante sauce	picante sauce	1
lime leaves	lime leaves	1
splenda granular	splenda granular	1
light rum	light rum	1
pear	pear	1
rye bread	rye bread	1
beef bouillon cubes	beef bouillon cubes	1
zwiebel	zwiebel	1
sirloin steak	sirloin steak	1
cod	cod	1
wonton wrappers	wonton wrappers	1
condensed milk	condensed milk	1
chorizo sausage	chorizo sausage	1
phyllo dough	phyllo dough	1
dark chocolate chips	dark chocolate chips	1
creme fraiche	creme fraiche	1
sweet red pepper	sweet red pepper	1
wild rice	wild rice	1
sourdough bread	sourdough bread	1
chicken legs	chicken legs	1
chorizo	chorizo	1
chinese five-spice powder	chinese five-spice powder	1
sweet pickle relish	sweet pickle relish	1
red grapes	red grapes	1
green tomatoes	green tomatoes	1
butter beans	butter beans	1
stevia	stevia	1
dry breadcrumbs	dry breadcrumbs	1
caraway seed	caraway seed	1
fish stock	fish stock	1
brown rice flour	brown rice flour	1
creamed corn	creamed corn	1
vanilla flavoring	vanilla flavoring	1
light cream cheese	light cream cheese	1
strawberry jam	strawberry jam	1
fennel seed	fennel seed	1
jasmine rice	jasmine rice	1
chuck roast	chuck roast	1
radicchio	radicchio	1
wheat	wheat	1
celery rib	celery rib	1
champagne vinegar	champagne vinegar	1
self-raising flour	self-raising flour	1
pork sausages	pork sausages	1
baby spinach leaves	baby spinach leaves	1
almond	almond	1
accent	accent	1
candy	candy	1
salad dressing	salad dressing	1
thickened cream	thickened cream	1
chickens	chickens	1
red lentils	red lentils	1
oat bran	oat bran	1
grenadine	grenadine	1
vanilla pudding mix	vanilla pudding mix	1
steak	steak	1
lime jello	lime jello	1
kiwi	kiwi	1
stewed tomatoes	stewed tomatoes	1
filling:	filling :	1
dijon-style mustard	dijon-style mustard	1
whiskey	whiskey	1
bamboo shoots	bamboo shoots	1
semisweet chocolate	semisweet chocolate	1
herbes de provence	herbes de provence	1
puff pastry sheets	puff pastry sheets	1
rotel tomatoes	rotel tomatoes	1
smoked salmon	smoked salmon	1
sweet pepper	sweet pepper	1
bread dough	bread dough	1
salt salt	salt salt	1
plain low-fat yogurt	plain low-fat yogurt	1
for 0.99	for 0.99	1
pizza doughs	pizza doughs	1
cinnamon sugar	cinnamon sugar	1
smoked sausage	smoked sausage	1
corn chips	corn chips	1
celery root	celery root	1
ramen noodles	ramen noodles	1
salami	salami	1
kraft grated parmesan cheese	kraft grated parmesan cheese	1
round steak	round steak	1
whole kernel corn	whole kernel corn	1
salt pork	salt pork	1
unsweetened shredded dried coconut	unsweetened shredded dried coconut	1
peach	peach	1
pimiento	pimiento	1
panko	panko	1
rye flour	rye flour	1
rolls	rolls	1
bok choy	bok choy	1
fish fillets	fish fillets	1
sweet milk	sweet milk	1
chicken stock cubes	chicken stock cubes	1
mangoes	mangoes	1
spaghetti squash	spaghetti squash	1
yukon gold potatoes	yukon gold potatoes	1
& pepper	& pepper	1
safflower oil	safflower oil	1
summer squash	summer squash	1
cookies	cookies	1
champagne	champagne	1
turkey sausage	turkey sausage	1
ml cream	ml cream	1
ml water	ml water	1
steak sauce	steak sauce	1
dry onion soup mix	dry onion soup mix	1
beef stew meat	beef stew meat	1
icing	icing	1
orange extract	orange extract	1
yellow onions	yellow onions	1
salz und pfeffer	salz und pfeffer	1
sugar pea	sugar pea	1
margarine butter	margarine butter	1
biscuit mix	biscuit mix	1
cream of chicken soup	cream of chicken soup	1
mascarpone cheese	mascarpone cheese	1
mandarin oranges	mandarin oranges	1
protein powder	protein powder	1
thick-cut bacon	thick-cut bacon	1
mixed berries	mixed berries	1
papaya	papaya	1
penne	penne	1
pickle relish	pickle relish	1
orange jello	orange jello	1
red chilli	red chilli	1
medjool date	medjool date	1
anchovy paste	anchovy paste	1
mango chutney	mango chutney	1
olive	olive	1
ei	ei	1
apple pie filling	apple pie filling	1
curry	curry	1
andouille sausage	andouille sausage	1
yellow food coloring	yellow food coloring	1
crimini mushrooms	crimini mushrooms	1
wheat bread	wheat bread	1
walnut oil	walnut oil	1
celery seeds	celery seeds	1
chipotle peppers	chipotle peppers	1
pie shells	pie shells	1
bittersweet chocolate	bittersweet chocolate	1
shiitake	shiitake	1
nectarines	nectarines	1
feta	feta	1
parmigiano-reggiano	parmigiano-reggiano	1
flat leaf parsley	flat leaf parsley	1
worcestershire	worcestershire	1
el olivenã¶l	el olivenã ¶ l	1
lime rind	lime rind	1
liqueur	liqueur	1
olive oil cooking spray	olive oil cooking spray	1
grapefruit	grapefruit	1
nutella	nutella	1
white corn syrup	white corn syrup	1
mexican cheese blend	mexican cheese blend	1
gluten	gluten	1
1.99	1.99	1
parmigiano reggiano cheese	parmigiano reggiano cheese	1
grits	grits	1
instant rice	instant rice	1
egg egg	egg egg	1
white rum	white rum	1
tub	tub	1
yams	yams	1
onion soup	onion soup	1
almond paste	almond paste	1
rum extract	rum extract	1
poblano chiles	poblano chiles	1
olive oil spray	olive oil spray	1
aldi â	aldi â  	1
honey mustard	honey mustard	1
potato starch	potato starch	1
oreoâ® cookies	oreoâ ® cookies	1
half-and-half cream	half-and-half cream	1
basil pesto	basil pesto	1
orzo pasta	orzo pasta	1
07/12	7 / 12	1
sweetener	sweetener	1
hot pepper	hot pepper	1
round	round	1
green grapes	green grapes	1
basil leaf	basil leaf	1
sherry wine vinegar	sherry wine vinegar	1
lime wedges	lime wedges	1
g mehl	g mehl	1
beef chuck	beef chuck	1
chili oil	chili oil	1
coffee liqueur	coffee liqueur	1
gruyã¨re cheese	gruyã ̈re cheese	1
pearl onions	pearl onions	1
adobo sauce	adobo sauce	1
grated parmesan cheese	grated parmesan cheese	1
jello	jello	1
buns	buns	1
coarse black pepper	coarse black pepper	1
green chiles	green chiles	1
pasta shells	pasta shells	1
salt pepper	salt pepper	1
vidalia onion	vidalia onion	1
chervil	chervil	1
lima beans	lima beans	1
bulgur	bulgur	1
red beans	red beans	1
port wine	port wine	1
food colouring	food colouring	1
spanish onion	spanish onion	1
currant	currant	1
kieasa	kieasa	1
pork loin chops	pork loin chops	1
sauce:	sauce :	1
strawberry jello	strawberry jello	1
chicken cutlets	chicken cutlets	1
liquid	liquid	1
jalapeã±o pepper	jalapeã ± o pepper	1
grating cheese	grating cheese	1
beef tenderloin	beef tenderloin	1
sweet italian sausage	sweet italian sausage	1
marinade	marinade	1
yellow pepper	yellow pepper	1
lg. cool whip	lg . cool whip	1
lemon lemon	lemon lemon	1
wheat tortillas	wheat tortillas	1
dutch-processed cocoa powder	dutch-processed cocoa powder	1
ancho powder	ancho powder	1
sultana	sultana	1
golden raisin	golden raisin	1
tarragon vinegar	tarragon vinegar	1
lime, juice of	lime , juice of	1
tapioca starch	tapioca starch	1
vanilla sugar	vanilla sugar	1
lemon cake mix	lemon cake mix	1
sirloin	sirloin	1
pastry shell	pastry shell	1
low-fat cream cheese	low-fat cream cheese	1
crab	crab	1
onion onion	onion onion	1
splenda sugar substitute	splenda sugar substitute	1
squid	squid	1
crisco oil	crisco oil	1
anise seed	anise seed	1
cacao powder	cacao powder	1
chicken bouillon cube	chicken bouillon cube	1
italian parsley	italian parsley	1
cornbread	cornbread	1
grapefruit juice	grapefruit juice	1
dash black pepper	dash black pepper	1
tomato ketchup	tomato ketchup	1
chile peppers	chile peppers	1
cheese tortellini	cheese tortellini	1
white cheddar cheese	white cheddar cheese	1
mayonnaise dressing	mayonnaise dressing	1
greens	greens	1
lemon zest	lemon zest	1
chillies	chillies	1
essence	essence	1
pickles	pickles	1
asiago cheese	asiago cheese	1
rice krispies cereal	rice krispies cereal	1
turmeric powder	turmeric powder	1
chunky salsa	chunky salsa	1
chicken livers	chicken livers	1
lemon curd	lemon curd	1
orzo	orzo	1
halibut	halibut	1
fren peas	fren peas	1
jelly	jelly	1
leaves	leaves	1
saltines	saltines	1
coffee granules	coffee granules	1
chutney	chutney	1
sharp cheddar cheese	sharp cheddar cheese	1
celery leaves	celery leaves	1
golden caster sugar	golden caster sugar	1
chipotles	chipotles	1
red-wine vinegar	red-wine vinegar	1
raw honey	raw honey	1
raspberry preserves	raspberry preserves	1
karo syrup	karo syrup	1
shredded mzarella cheese	shredded mzarella cheese	1
jar spaghetti sauce	jar spaghetti sauce	1
lg. egg	lg . egg	1
collard greens	collard greens	1
saltine crackers	saltine crackers	1
phyllo pastry	phyllo pastry	1
hot dogs	hot dogs	1
ginger paste	ginger paste	1
whole wheat bread	whole wheat bread	1
beef short ribs	beef short ribs	1
dillweed	dillweed	1
topping:	topping :	1
cream-style corn	cream-style corn	1
fettucine	fettucine	1
queso fresco	queso fresco	1
mayo	mayo	1
ground sirloin	ground sirloin	1
turbinado	turbinado	1
asiago	asiago	1
hash browns	hash browns	1
sweet potato	sweet potato	1
salt and white pepper	salt and white pepper	1
almond flavoring	almond flavoring	1
ground lamb	ground lamb	1
alfredo sauce	alfredo sauce	1
knoblauchzehe	knoblauchzehe	1
black sesame seeds	black sesame seeds	1
chicken bouillon granules	chicken bouillon granules	1
meatballs	meatballs	1
cumin powder	cumin powder	1
chicken meat	chicken meat	1
italian bread	italian bread	1
oil oil	oil oil	1
onions onion	onions onion	1
zout	zout	1
g butter	g butter	1
turkey bacon	turkey bacon	1
red chilies	red chilies	1
juniper berries	juniper berries	1
lime peel	lime peel	1
soymilk	soymilk	1
serrano peppers	serrano peppers	1
granola	granola	1
escarole	escarole	1
2.99	2.99	1
green chili peppers	green chili peppers	1
pistachio nuts	pistachio nuts	1
baking mix	baking mix	1
lemon pepper seasoning	lemon pepper seasoning	1
beef turkey	beef turkey	1
ladyfingers	ladyfingers	1
bay scallops	bay scallops	1
butter lettuce	butter lettuce	1
salsa verde	salsa verde	1
sugar sugar	sugar sugar	1
hamburger meat	hamburger meat	1
marshmallow cream	marshmallow cream	1
allspice berries	allspice berries	1
chicken pieces	chicken pieces	1
dream whip	dream whip	1
apple butter	apple butter	1
apricot nectar	apricot nectar	1
cinnamon ground	cinnamon ground	1
eier	eier	1
duck	duck	1
pecorino cheese	pecorino cheese	1
mixed nuts	mixed nuts	1
breadcrumb	breadcrumb	1
sugar snap peas	sugar snap peas	1
coriander seed	coriander seed	1
lobster	lobster	1
golden brown sugar	golden brown sugar	1
cooking sherry	cooking sherry	1
corn meal	corn meal	1
matzo meal	matzo meal	1
light soy sauce	light soy sauce	1
brownie mix	brownie mix	1
melon	melon	1
raw rice	raw rice	1
vinaigrette	vinaigrette	1
soba noodles	soba noodles	1
marjoram dried	marjoram dried	1
shaoxing wine	shaoxing wine	1
free less sodium chicken broth	free less sodium chicken broth	1
cereal	cereal	1
rigatoni	rigatoni	1
tater tots	tater tots	1
tilapia fillets	tilapia fillets	1
cinnamon stick	cinnamon stick	1
garlic chili sauce	garlic chili sauce	1
beef stock cubes	beef stock cubes	1
wheat bran	wheat bran	1
dressing:	dressing :	1
endive	endive	1
mushrooms mushrooms	mushrooms mushrooms	1
turnip	turnip	1
pastry flour	pastry flour	1
baby arugula	baby arugula	1
cornflakes	cornflakes	1
tuna steaks	tuna steaks	1
beef consomme	beef consomme	1
nonstick cooking spray	nonstick cooking spray	1
crisco shortening	crisco shortening	1
2% low-fat milk	2 % low-fat milk	1
leaf parsley	leaf parsley	1
pepper jack	pepper jack	1
can cream style corn	can cream style corn	1
pork butt	pork butt	1
angostura bitters	angostura bitters	1
deli ham	deli ham	1
pork roast	pork roast	1
ginger ginger	ginger ginger	1
self rising flour	self rising flour	1
five-spice powder	five-spice powder	1
fine salt	fine salt	1
sumac	sumac	1
sweet basil	sweet basil	1
stuffing	stuffing	1
rutabaga	rutabaga	1
hominy	hominy	1
baby bok choy	baby bok choy	1
thyme thyme	thyme thyme	1
fettuccine	fettuccine	1
key lime juice	key lime juice	1
chocolate pudding	chocolate pudding	1
dry coconut	dry coconut	1
crust	crust	1
red hot pepper sauce	red hot pepper sauce	1
angel hair	angel hair	1
coy cheese	coy cheese	1
chocolate instant pudding	chocolate instant pudding	1
chipotle chiles	chipotle chiles	1
sausage links	sausage links	1
harissa	harissa	1
tapioca	tapioca	1
bosc pears	bosc pears	1
arrowroot	arrowroot	1
lg. marshmallows	lg . marshmallows	1
rose water	rose water	1
fig	fig	1
instant coffee granules	instant coffee granules	1
pie filling	pie filling	1
baby greens	baby greens	1
raspberry jello	raspberry jello	1
potatoes potatoes	potatoes potatoes	1
basil basil	basil basil	1
dill seed	dill seed	1
ranch dressing	ranch dressing	1
white miso	white miso	1
hass avocado	hass avocado	1
sausage casings	sausage casings	1
for 5.00	for 5	1
pizza dough	pizza dough	1
brown lentils	brown lentils	1
sun-dried tomato	sun-dried tomato	1
seasoned bread crumbs	seasoned bread crumbs	1
chicken fingers	chicken fingers	1
beans beans	beans beans	1
green chile	green chile	1
103/4 cream of mushroom soup	103 / 4 cream of mushroom soup	1
hellmann's mayonnaise	hellmann 's mayonnaise	1
semi-sweet chocolate	semi-sweet chocolate	1
manchego cheese	manchego cheese	1
sweet butter	sweet butter	1
extra virgin olive oil	extra virgin olive oil	1
softened cream cheese	softened cream cheese	1
lg. onions	lg . onions	1
hummus	hummus	1
maple extract	maple extract	1
beef bouillon cube	beef bouillon cube	1
lg. tomatoes	lg . tomatoes	1
coconut water	coconut water	1
flavoring	flavoring	1
pepper sauce	pepper sauce	1
chickpea flour	chickpea flour	1
amaretto liqueur	amaretto liqueur	1
tamarind paste	tamarind paste	1
toast	toast	1
edamame	edamame	1
kale leaves	kale leaves	1
orange juice concentrate	orange juice concentrate	1
stew meat	stew meat	1
shredded swiss cheese	shredded swiss cheese	1
capsicum	capsicum	1
german chocolate cake mix	german chocolate cake mix	1
baking cocoa	baking cocoa	1
ml	ml	1
stuffing mix	stuffing mix	1
maraschino cherry	maraschino cherry	1
dressing mix	dressing mix	1
hard-boiled egg	hard-boiled egg	1
pomegranate	pomegranate	1
hemp seeds	hemp seeds	1
dill pickle	dill pickle	1
finely nuts	finely nuts	1
french baguette	french baguette	1
maple flavoring	maple flavoring	1
bacon grease	bacon grease	1
pickling salt	pickling salt	1
skirt steak	skirt steak	1
lettuce leaf	lettuce leaf	1
buckwheat flour	buckwheat flour	1
broccoli rabe	broccoli rabe	1
ml white wine	ml white wine	1
kirsch	kirsch	1
bread bread	bread bread	1
green cardamom pods	green cardamom pods	1
pomegranate molasses	pomegranate molasses	1
cocktail cherries	cocktail cherries	1
potato chips	potato chips	1
cardamom seeds	cardamom seeds	1
rocket leaves	rocket leaves	1
fleur de sel	fleur de sel	1
raspberry vinegar	raspberry vinegar	1
bulk pork sausage	bulk pork sausage	1
msg	msg	1
oat flour	oat flour	1
sq. chocolate	sq . chocolate	1
tart cherries	tart cherries	1
thawed cool whip whipped topping	thawed cool whip whipped topping	1
saffron threads	saffron threads	1
masa harina	masa harina	1
chili pepper flakes	chili pepper flakes	1
beef bouillon granules	beef bouillon granules	1
vanilla protein powder	vanilla protein powder	1
vanilla pods	vanilla pods	1
extract	extract	1
tomatoes and green chilies	tomatoes and green chilies	1
pancake mix	pancake mix	1
vegetable oil oil	vegetable oil oil	1
chicken breast fillets	chicken breast fillets	1
mint extract	mint extract	1
rotini	rotini	1
vanilla wafer crumbs	vanilla wafer crumbs	1
cream of coconut	cream of coconut	1
kaiser rolls	kaiser rolls	1
beef sirloin	beef sirloin	1
muenster cheese	muenster cheese	1
tea	tea	1
walnuts pecans	walnuts pecans	1
hershey's cocoa	hershey 's cocoa	1
ingredients:	ingredients :	1
pt strawberries	pt strawberries	1
scissors	scissors	1
chocolate frosting	chocolate frosting	1
eggnog	eggnog	1
fenugreek seeds	fenugreek seeds	1
plantains	plantains	1
reducedcream cheese	reducedcream cheese	1
demerara sugar	demerara sugar	1
baking potatoes	baking potatoes	1
monterey jack pepper cheese	monterey jack pepper cheese	1
minced garlic	minced garlic	1
ml red wine	ml red wine	1
cherry juice	cherry juice	1
condensed cream of chicken soup	condensed cream of chicken soup	1
07/09	7 / 9	1
coconut rum	coconut rum	1
smoked ham	smoked ham	1
creole mustard	creole mustard	1
english peas	english peas	1
whole grain mustard	whole grain mustard	1
lobster meat	lobster meat	1
refrigerated crescent rolls	refrigerated crescent rolls	1
caramel ice cream topping	caramel ice cream topping	1
beef roast	beef roast	1
burgundy wine	burgundy wine	1
country bread	country bread	1
processed cheese	processed cheese	1
white karo syrup	white karo syrup	1
apple jelly	apple jelly	1
chinese noodles	chinese noodles	1
plum tomato	plum tomato	1
black mustard seeds	black mustard seeds	1
halibut fillets	halibut fillets	1
salt black pepper	salt black pepper	1
pico de gallo	pico de gallo	1
green chili	green chili	1
canadian bacon	canadian bacon	1
graham cracker pie crust	graham cracker pie crust	1
chocolate ice cream	chocolate ice cream	1
butter softened	butter softened	1
breakstone's	breakstone 's	1
red chili pepper	red chili pepper	1
french dressing	french dressing	1
tilapia	tilapia	1
seasoned rice wine vinegar	seasoned rice wine vinegar	1
crust:	crust :	1
whole wheat white flour	whole wheat white flour	1
chicken parts	chicken parts	1
m&m's candy	m & m 's candy	1
ground cayenne pepper	ground cayenne pepper	1
white button mushrooms	white button mushrooms	1
pet milk	pet milk	1
irish whiskey	irish whiskey	1
cracked pepper	cracked pepper	1
cointreau	cointreau	1
limeade	limeade	1
semolina	semolina	1
peper	peper	1
rib celery	rib celery	1
olive oil flavored cooking spray	olive oil flavored cooking spray	1
g zucker	g zucker	1
cream cheese softened	cream cheese softened	1
pork & beans	pork & beans	1
ham hock	ham hock	1
vanilla instant pudding mix	vanilla instant pudding mix	1
boston lettuce	boston lettuce	1
white rice flour	white rice flour	1
white sandwich bread	white sandwich bread	1
apple pie spice	apple pie spice	1
g schlagsahne	g schlagsahne	1
lamb shanks	lamb shanks	1
pita bread	pita bread	1
pecans walnuts	pecans walnuts	1
fusilli	fusilli	1
white balsamic vinegar	white balsamic vinegar	1
dinner rolls	dinner rolls	1
pepitas	pepitas	1
vermicelli	vermicelli	1
zehe/n knoblauch	zehe / n knoblauch	1
craisins	craisins	1
strawberry preserves	strawberry preserves	1
cilantro leaf	cilantro leaf	1
bread cubes	bread cubes	1
butter butter	butter butter	1
mint sprigs	mint sprigs	1
white-wine vinegar	white-wine vinegar	1
savory	savory	1
lemon slices	lemon slices	1
pt cherry tomatoes	pt cherry tomatoes	1
malt vinegar	malt vinegar	1
lemon grass	lemon grass	1
tortilla	tortilla	1
quick-cooking tapioca	quick-cooking tapioca	1
103/4 cream of chicken soup	103 / 4 cream of chicken soup	1
seafood seasoning	seafood seasoning	1
chocolate bars	chocolate bars	1
grated cheese	grated cheese	1
flounder	flounder	1
swerve sweetener	swerve sweetener	1
marinated artichoke hearts	marinated artichoke hearts	1
sweet vermouth	sweet vermouth	1
unsalted chicken stock	unsalted chicken stock	1
lipton onion soup mix	lipton onion soup mix	1
beef gravy	beef gravy	1
smoked bacon	smoked bacon	1
farro	farro	1
buffalo sauce	buffalo sauce	1
bacon drippings	bacon drippings	1
boneless skinless chicken thighs	boneless skinless chicken thighs	1
shredded sharp cheddar cheese	shredded sharp cheddar cheese	1
corn husks	corn husks	1
. sugar	. sugar	1
red currant jelly	red currant jelly	1
potato flakes	potato flakes	1
ml milch	ml milch	1
mung bean sprouts	mung bean sprouts	1
water cold	water cold	1
blood orange	blood orange	1
pork ribs	pork ribs	1
pickling spices	pickling spices	1
pea pods	pea pods	1
candy canes	candy canes	1
venison	venison	1
tapioca flour	tapioca flour	1
refrigerated piecrusts	refrigerated piecrusts	1
margarine softened	margarine softened	1
vanilla frosting	vanilla frosting	1
pork spareribs	pork spareribs	1
sweet onions	sweet onions	1
cranberry juice cocktail	cranberry juice cocktail	1
raspberry	raspberry	1
white sesame seeds	white sesame seeds	1
oyster mushrooms	oyster mushrooms	1
bow-tie pasta	bow-tie pasta	1
lg. cream cheese	lg . cream cheese	1
eggs egg	eggs egg	1
white wine dry	white wine dry	1
7-up	7 -up	1
knoblauchzehen	knoblauchzehen	1
avocado oil	avocado oil	1
egg whites	egg whites	1
lemonade concentrate	lemonade concentrate	1
kiwi fruits	kiwi fruits	1
parsnip	parsnip	1
sweet red bell peppers	sweet red bell peppers	1
carton cool whip	carton cool whip	1
water boiling	water boiling	1
fava beans	fava beans	1
purpose flour	purpose flour	1
pork belly	pork belly	1
asian fish sauce	asian fish sauce	1
chicken stock stock	chicken stock stock	1
liquid honey	liquid honey	1
thousand island dressing	thousand island dressing	1
caramel topping	caramel topping	1
orange segments	orange segments	1
granny smith apple	granny smith apple	1
salt flakes	salt flakes	1
cake:	cake :	1
cooked noodles	cooked noodles	1
slaw mix	slaw mix	1
pie dough	pie dough	1
scallions onions	scallions onions	1
string beans	string beans	1
eieren	eieren	1
steak seasoning	steak seasoning	1
bulk sausage	bulk sausage	1
chicken sausage	chicken sausage	1
red-pepper flakes	red-pepper flakes	1
white peppercorns	white peppercorns	1
crumbled blue cheese	crumbled blue cheese	1
10x sugar	10 x sugar	1
kraft miracle whip dressing	kraft miracle whip dressing	1
cubes	cubes	1
anchovy fillets	anchovy fillets	1
the fresh market â	the fresh market â  	1
soup	soup	1
sweet peas	sweet peas	1
cider	cider	1
pectin	pectin	1
coconut butter	coconut butter	1
can green chilies	can green chilies	1
neutral oil	neutral oil	1
broccoli flowerets	broccoli flowerets	1
white onions	white onions	1
wasabi paste	wasabi paste	1
red pepper sauce	red pepper sauce	1
ginger ground	ginger ground	1
softened butter	softened butter	1
round steaks	round steaks	1
miso	miso	1
biscuit baking mix	biscuit baking mix	1
tea bags	tea bags	1
creme de cacao	creme de cacao	1
pitas	pitas	1
green lentil	green lentil	1
cornbread mix	cornbread mix	1
onion rings	onion rings	1
rice chex	rice chex	1
meyer lemons	meyer lemons	1
rib eye steaks	rib eye steaks	1
habanero pepper	habanero pepper	1
broccoli spears	broccoli spears	1
wedge	wedge	1
orange sherbet	orange sherbet	1
alum	alum	1
fryer	fryer	1
yellow mustard seeds	yellow mustard seeds	1
cotija	cotija	1
muscovado sugar	muscovado sugar	1
tamari	tamari	1
balsamico bianco	balsamico bianco	1
chocolate shavings	chocolate shavings	1
mint leaf	mint leaf	1
cornish hens	cornish hens	1
toasted sesame oil	toasted sesame oil	1
pkgs. yeast	pkgs . yeast	1
fren hash brown potatoes	fren hash brown potatoes	1
spring onion	spring onion	1
chicken base	chicken base	1
chinese rice wine	chinese rice wine	1
salad leaves	salad leaves	1
artificial sweetener	artificial sweetener	1
chicken stock chicken broth	chicken stock chicken broth	1
condensed tomato soup	condensed tomato soup	1
seasoned rice vinegar	seasoned rice vinegar	1
heirloom tomatoes	heirloom tomatoes	1
flax seed	flax seed	1
dry bread crumbs	dry bread crumbs	1
peach schnapps	peach schnapps	1
red chili	red chili	1
jumbo shrimp	jumbo shrimp	1
hoagie rolls	hoagie rolls	1
sourdough starter	sourdough starter	1
butter flavoring	butter flavoring	1
water warm	water warm	1
bar	bar	1
chocolate sauce	chocolate sauce	1
pimientos	pimientos	1
swiss chard	swiss chard	1
corn flake crumbs	corn flake crumbs	1
broccolini	broccolini	1
cointreau liqueur	cointreau liqueur	1
packed light-brown sugar	packed light-brown sugar	1
free cream cheese	free cream cheese	1
salad:	salad :	1
white syrup	white syrup	1
dogs	dogs	1
evoo	evoo	1
raw sugar	raw sugar	1
pickle juice	pickle juice	1
teentjes knoflook	teentjes knoflook	1
whitefish	whitefish	1
roquefort cheese	roquefort cheese	1
berry cranberry sauce	berry cranberry sauce	1
peppercorn	peppercorn	1
splenda	splenda	1
cherry jello	cherry jello	1
havarti cheese	havarti cheese	1
cola	cola	1
white corn	white corn	1
garden fresh market â	garden fresh market â  	1
spanish paprika	spanish paprika	1
sea salt flakes	sea salt flakes	1
spiced rum	spiced rum	1
coarse salt	coarse salt	1
lowcottage cheese	lowcottage cheese	1
cube	cube	1
sole	sole	1
orange flower water	orange flower water	1
doritos	doritos	1
ui	ui	1
arrowroot powder	arrowroot powder	1
taco shells	taco shells	1
ice water	ice water	1
french fried onions	french fried onions	1
luke warm water	luke warm water	1
crumbs	crumbs	1
pretzel sticks	pretzel sticks	1
coconut aminos	coconut aminos	1
green peppercorns	green peppercorns	1
whipped cream cheese	whipped cream cheese	1
unsalted cashews	unsalted cashews	1
miso paste	miso paste	1
cream corn	cream corn	1
pecan pieces	pecan pieces	1
mushrooms sliced	mushrooms sliced	1
italian cheese	italian cheese	1
sprouts	sprouts	1
radish	radish	1
mixed salad greens	mixed salad greens	1
granulated sugar	granulated sugar	1
pizza crust	pizza crust	1
lemon flavoring	lemon flavoring	1
blueberry pie filling	blueberry pie filling	1
daikon	daikon	1
chicken tenders	chicken tenders	1
quick cooking oats	quick cooking oats	1
devil's food cake mix	devil 's food cake mix	1
himalayan salt	himalayan salt	1
rice milk	rice milk	1
milk milk	milk milk	1
breakfast sausages	breakfast sausages	1
shortcrust pastry	shortcrust pastry	1
mini chocolate chips	mini chocolate chips	1
citron	citron	1
chocolate squares	chocolate squares	1
cornichons	cornichons	1
turkey meat	turkey meat	1
stewing beef	stewing beef	1
calvados	calvados	1
port	port	1
lemon gelatin	lemon gelatin	1
tangerine	tangerine	1
lg. carrots	lg . carrots	1
canola oil oil	canola oil oil	1
baked beans	baked beans	1
salt, pepper	salt , pepper	1
low sodium chicken broth	low sodium chicken broth	1
artichoke	artichoke	1
brisket	brisket	1
milk skim	milk skim	1
celery sticks	celery sticks	1
erythritol	erythritol	1
cream cheese frosting	cream cheese frosting	1
onions onions	onions onions	1
cooking wine	cooking wine	1
italian plum tomatoes	italian plum tomatoes	1
zucker	zucker	1
soy	soy	1
crushed garlic	crushed garlic	1
raw shrimp	raw shrimp	1
t butter	t butter	1
el tomatenmark	el tomatenmark	1
marjoram leaves	marjoram leaves	1
crawfish	crawfish	1
veggies	veggies	1
salt chicken broth	salt chicken broth	1
grape jelly	grape jelly	1
pizza	pizza	1
chocolate curls	chocolate curls	1
kitchen bouquet	kitchen bouquet	1
pkgs cream cheese	pkgs cream cheese	1
101/2 cream of mushroom soup	101 / 2 cream of mushroom soup	1
sweet pickles	sweet pickles	1
horseradish sauce	horseradish sauce	1
bund petersilie	bund petersilie	1
chocolate bits	chocolate bits	1
millet	millet	1
bran	bran	1
corn corn	corn corn	1
haricots verts	haricots verts	1
catfish	catfish	1
chevre	chevre	1
balsamic vinaigrette	balsamic vinaigrette	1
shiitake mushroom caps	shiitake mushroom caps	1
skewers	skewers	1
pecorino	pecorino	1
margarine, softened	margarine , softened	1
chocolate wafer cookies	chocolate wafer cookies	1
sweet cherries	sweet cherries	1
11/2 dried oregano	11 / 2 dried oregano	1
cheddar cheese shredded	cheddar cheese shredded	1
vanilla vodka	vanilla vodka	1
sultanas	sultanas	1
water stock	water stock	1
juice lemon	juice lemon	1
confectioner's sugar	confectioner 's sugar	1
italian seasoned breadcrumbs	italian seasoned breadcrumbs	1
vanilla almond milk	vanilla almond milk	1
lg. potatoes	lg . potatoes	1
target â	target â  	1
jiffy corn muffin mix	jiffy corn muffin mix	1
bread machine yeast	bread machine yeast	1
baby	baby	1
oregano oregano	oregano oregano	1
cream of mushroom soup, undiluted	cream of mushroom soup , undiluted	1
coffee beans	coffee beans	1
pepper flakes	pepper flakes	1
hot peppers	hot peppers	1
truffle oil	truffle oil	1
ground cumin	ground cumin	1
buttermilk milk	buttermilk milk	1
carrots carrots	carrots carrots	1
salmon steaks	salmon steaks	1
chocolate chip	chocolate chip	1
pork loin roast	pork loin roast	1
yellow bell peppers	yellow bell peppers	1
peach preserves	peach preserves	1
golden mushroom soup	golden mushroom soup	1
. chuck	. chuck	1
kosher salt	kosher salt	1
sweet relish	sweet relish	1
rosemary rosemary	rosemary rosemary	1
light brown sugar	light brown sugar	1
wasabi powder	wasabi powder	1
tortellini	tortellini	1
g champignons	g champignons	1
tasty cheese	tasty cheese	1
shallots onion	shallots onion	1
coca-cola	coca-cola	1
soya sauce	soya sauce	1
peanut oil oil	peanut oil oil	1
broccoli floret	broccoli floret	1
pepper cheese	pepper cheese	1
frangelico	frangelico	1
dry milk	dry milk	1
wheat breadcrumbs	wheat breadcrumbs	1
kraft real mayo mayonnaise	kraft real mayo mayonnaise	1
flour all-purpose	flour all-purpose	1
chile paste	chile paste	1
pumpernickel bread	pumpernickel bread	1
ml olive oil	ml olive oil	1
chilli flakes	chilli flakes	1
croissants	croissants	1
pineapples	pineapples	1
sandwich bread	sandwich bread	1
low sodium vegetable broth	low sodium vegetable broth	1
vanilla powder	vanilla powder	1
gluten-free flour	gluten-free flour	1
fettuccine pasta	fettuccine pasta	1
grape juice	grape juice	1
chocolate pudding mix	chocolate pudding mix	1
shells	shells	1
medjool dates	medjool dates	1
pork tenderloins	pork tenderloins	1
alfalfa sprouts	alfalfa sprouts	1
english mustard	english mustard	1
kraft caramels	kraft caramels	1
wholegrain mustard	wholegrain mustard	1
cocoa baking	cocoa baking	1
marshmallow fluff	marshmallow fluff	1
bibb lettuce	bibb lettuce	1
coffee creamer	coffee creamer	1
sprite	sprite	1
clear honey	clear honey	1
bacon rashers	bacon rashers	1
coffee powder	coffee powder	1
toothpicks	toothpicks	1
catfish fillets	catfish fillets	1
grey poupon dijon mustard	grey poupon dijon mustard	1
orange sections	orange sections	1
accent seasoning	accent seasoning	1
sanding sugar	sanding sugar	1
liquid stevia	liquid stevia	1
gouda	gouda	1
white cornmeal	white cornmeal	1
ruby port	ruby port	1
ranch	ranch	1
pickling spice	pickling spice	1
hard-boiled eggs	hard-boiled eggs	1
tamari soy sauce	tamari soy sauce	1
cilantro sprigs	cilantro sprigs	1
trout	trout	1
reducedcheddar cheese	reducedcheddar cheese	1
eagle brand condensed milk	eagle brand condensed milk	1
italian sausages	italian sausages	1
ciabatta	ciabatta	1
lavender	lavender	1
lamb shoulder	lamb shoulder	1
hungarian paprika	hungarian paprika	1
chicken thigh fillets	chicken thigh fillets	1
green curry paste	green curry paste	1
shrimp paste	shrimp paste	1
sesame seed	sesame seed	1
baby corn	baby corn	1
toffee bits	toffee bits	1
black coffee	black coffee	1
gouda cheese	gouda cheese	1
ham steak	ham steak	1
chicken turkey	chicken turkey	1
env. onion soup mix	env . onion soup mix	1
vital wheat gluten	vital wheat gluten	1
spam	spam	1
peas and carrots	peas and carrots	1
adobo seasoning	adobo seasoning	1
banana peppers	banana peppers	1
pineapple rings	pineapple rings	1
el butter	el butter	1
instant espresso powder	instant espresso powder	1
cheez whiz	cheez whiz	1
gorgonzola cheese	gorgonzola cheese	1
duck breasts	duck breasts	1
roast	roast	1
bouquet garni	bouquet garni	1
for 1.69	for 1.69	1
el zitronensaft	el zitronensaft	1
cacao nibs	cacao nibs	1
custard powder	custard powder	1
wax beans	wax beans	1
coke	coke	1
liquor	liquor	1
galangal	galangal	1
bulgur wheat	bulgur wheat	1
paprikaschote	paprikaschote	1
chipotle powder	chipotle powder	1
ranch style beans	ranch style beans	1
rabbit	rabbit	1
mincemeat	mincemeat	1
garlic garlic powder	garlic garlic powder	1
madeira	madeira	1
baby peas	baby peas	1
whole allspice	whole allspice	1
chocolate wafer crumbs	chocolate wafer crumbs	1
beef mince	beef mince	1
hash brown potatoes	hash brown potatoes	1
vegetable	vegetable	1
dipping sauce	dipping sauce	1
swordfish	swordfish	1
baby potatoes	baby potatoes	1
chicken breast tenders	chicken breast tenders	1
fruit juice	fruit juice	1
gravy	gravy	1
szechwan peppercorns	szechwan peppercorns	1
portabella mushrooms	portabella mushrooms	1
thai fish sauce	thai fish sauce	1
jar salsa	jar salsa	1
flour tortilla	flour tortilla	1
a.1. original sauce	a. 1 . original sauce	1
frosting:	frosting :	1
light karo syrup	light karo syrup	1
butter flavor shortening	butter flavor shortening	1
nori	nori	1
jalapeã±o	jalapeã ± o	1
golden delicious apples	golden delicious apples	1
all-bran cereal	all-bran cereal	1
nonstick vegetable oil spray	nonstick vegetable oil spray	1
stevia extract	stevia extract	1
el mehl	el mehl	1
lemon-lime soda	lemon-lime soda	1
prise salz	prise salz	1
seasoned croutons	seasoned croutons	1
fritos	fritos	1
lg. bananas	lg . bananas	1
bartlett pears	bartlett pears	1
mixed greens	mixed greens	1
lobster tails	lobster tails	1
gingersnap cookies	gingersnap cookies	1
dulce de leche	dulce de leche	1
madeira wine	madeira wine	1
lemon wedge	lemon wedge	1
winter squash	winter squash	1
reducedmayonnaise	reducedmayonnaise	1
flour flour	flour flour	1
red onion, diced	red onion , diced	1
lemons, juice of	lemons , juice of	1
pastry dough	pastry dough	1
old fashioned oats	old fashioned oats	1
oleo	oleo	1
brown potatoes	brown potatoes	1
oyster crackers	oyster crackers	1
red chillies	red chillies	1
brown rice syrup	brown rice syrup	1
veal stock	veal stock	1
tart apple	tart apple	1
ginger powder	ginger powder	1
sour cherries	sour cherries	1
granola cereal	granola cereal	1
sweet peppers	sweet peppers	1
refrigerated biscuits	refrigerated biscuits	1
meyer lemon juice	meyer lemon juice	1
red enchilada sauce	red enchilada sauce	1
clementines	clementines	1
chick peas	chick peas	1
italian salad dressing mix	italian salad dressing mix	1
mixed herbs	mixed herbs	1
asian sesame oil	asian sesame oil	1
blend cheese	blend cheese	1
garlic powder garlic	garlic powder garlic	1
chinese five spice powder	chinese 5 spice powder	1
herb seasoned stuffing mix	herb seasoned stuffing mix	1
rice vermicelli	rice vermicelli	1
rubbed sage	rubbed sage	1
baileys irish cream liqueur	baileys irish cream liqueur	1
dry	dry	1
cakes	cakes	1
vermouth	vermouth	1
suet	suet	1
fennel fronds	fennel fronds	1
green tea	green tea	1
unsalted pistachios	unsalted pistachios	1
french style green beans	french style green beans	1
x vegetable oil	x vegetable oil	1
corn muffin mix	corn muffin mix	1
chickpeas beans	chickpeas beans	1
egg roll wrappers	egg roll wrappers	1
angel flake coconut	angel flake coconut	1
pt. strawberries	pt . strawberries	1
white bread flour	white bread flour	1
coffee ice cream	coffee ice cream	1
cooked shrimp	cooked shrimp	1
short-grain rice	short-grain rice	1
chocolate sandwich cookies	chocolate sandwich cookies	1
peppermint	peppermint	1
each egg yolks	each egg yolks	1
yolk	yolk	1
gala apples	gala apples	1
shredded zucchini	shredded zucchini	1
pkg cream cheese	pkg cream cheese	1
plum sauce	plum sauce	1
coleslaw	coleslaw	1
tuna fish	tuna fish	1
popcorn kernels	popcorn kernels	1
pernod	pernod	1
sandwich buns	sandwich buns	1
rotelle	rotelle	1
white raisins	white raisins	1
bouillon	bouillon	1
sweet pickle	sweet pickle	1
glaze:	glaze :	1
dark beer	dark beer	1
cream sherry	cream sherry	1
fat-free buttermilk	fat-free buttermilk	1
whip topping	whip topping	1
walgreens â	walgreens â  	1
longhorn cheese	longhorn cheese	1
gnocchi	gnocchi	1
limes, juice of	limes , juice of	1
chipotle pepper	chipotle pepper	1
ripe bananas,	ripe bananas ,	1
jar	jar	1
vegan margarine	vegan margarine	1
instant tea	instant tea	1
11/4 baking soda	11 / 4 baking soda	1
olive oil vegetable oil	olive oil vegetable oil	1
sugar syrup	sugar syrup	1
veal cutlets	veal cutlets	1
fruits	fruits	1
genoa salami	genoa salami	1
frankfurters	frankfurters	1
green leaf lettuce	green leaf lettuce	1
jack	jack	1
hot pepper flakes	hot pepper flakes	1
powdered sugar	powdered sugar	1
minute tapioca	minute tapioca	1
planters pecans	planters pecans	1
chile sauce	chile sauce	1
tempeh	tempeh	1
sweet rice flour	sweet rice flour	1
cream milk	cream milk	1
splenda brown sugar blend	splenda brown sugar blend	1
cabbage leaves	cabbage leaves	1
arugula leaves	arugula leaves	1
risotto rice	risotto rice	1
italian cheese blend	italian cheese blend	1
red snapper	red snapper	1
blood orange juice	blood orange juice	1
bitters	bitters	1
kumquats	kumquats	1
fine bread crumbs	fine bread crumbs	1
chilli powder	chilli powder	1
salted cashews	salted cashews	1
sweet and sour sauce	sweet and sour sauce	1
limoncello	limoncello	1
mixed fruit	mixed fruit	1
whole cranberry sauce	whole cranberry sauce	1
zucchini squash	zucchini squash	1
shredded pepper jack cheese	shredded pepper jack cheese	1
101/2 cream of chicken soup	101 / 2 cream of chicken soup	1
hot sausage	hot sausage	1
tomaten	tomaten	1
greek seasoning	greek seasoning	1
mushroom caps	mushroom caps	1
brown mustard seeds	brown mustard seeds	1
wide egg noodles	wide egg noodles	1
white grape juice	white grape juice	1
walnut pieces	walnut pieces	1
pkgs. cream cheese	pkgs . cream cheese	1
melon liqueur	melon liqueur	1
split peas	split peas	1
pink peppercorns	pink peppercorns	1
romaine	romaine	1
white potatoes	white potatoes	1
white kidney beans	white kidney beans	1
wasabi	wasabi	1
palm sugar	palm sugar	1
dark molasses	dark molasses	1
brown gravy mix	brown gravy mix	1
. shrimp	. shrimp	1
turkey stock	turkey stock	1
miracle whip dressing	miracle whip dressing	1
smoked gouda	smoked gouda	1
pistachio pudding	pistachio pudding	1
pea shoots	pea shoots	1
fontina	fontina	1
sweet red peppers	sweet red peppers	1
rib	rib	1
sweet potatoes large	sweet potatoes large	1
coleslaw mix	coleslaw mix	1
tahini paste	tahini paste	1
haddock	haddock	1
banana liqueur	banana liqueur	1
barbeque sauce	barbeque sauce	1
bisquick mix	bisquick mix	1
aluminum foil	aluminum foil	1
lobsters	lobsters	1
corned beef	corned beef	1
apricot brandy	apricot brandy	1
beefsteak tomatoes	beefsteak tomatoes	1
nutritional yeast flakes	nutritional yeast flakes	1
stilton cheese	stilton cheese	1
spelt flour	spelt flour	1
chipotle	chipotle	1
lebanese cucumber	lebanese cucumber	1
cherry preserves	cherry preserves	1
oscar mayer bacon	oscar mayer bacon	1
nut meats	nut meats	1
fren whole kernel corn	fren whole kernel corn	1
soy flour	soy flour	1
linguini	linguini	1
gruyere	gruyere	1
chocolate candy	chocolate candy	1
icing sugar mixture	icing sugar mixture	1
jell-o gelatin	jell-o gelatin	1
sriracha sauce	sriracha sauce	1
cheerios	cheerios	1
brioche	brioche	1
eagle brand sweetened condensed milk	eagle brand sweetened condensed milk	1
phyllo	phyllo	1
wheat pita bread	wheat pita bread	1
passion fruit	passion fruit	1
11/2 vegetable oil	11 / 2 vegetable oil	1
green chili pepper	green chili pepper	1
chocolate chunks	chocolate chunks	1
white sauce	white sauce	1
chocolate chocolate	chocolate chocolate	1
pink grapefruit	pink grapefruit	1
tub cool whip	tub cool whip	1
eige	eige	1
yellow split peas	yellow split peas	1
mint sprig	mint sprig	1
ml buttermilk	ml buttermilk	1
crepes	crepes	1
coconut oil oil	coconut oil oil	1
style cheese	style cheese	1
streaky bacon	streaky bacon	1
mustard greens	mustard greens	1
carob powder	carob powder	1
kimchi	kimchi	1
white truffle oil	white truffle oil	1
creme de menthe	creme de menthe	1
napa cabbage	napa cabbage	1
kraft original barbecue sauce	kraft original barbecue sauce	1
tangerine juice	tangerine juice	1
hearts of palm	hearts of palm	1
corn tortilla chips	corn tortilla chips	1
ziti	ziti	1
belgian endive	belgian endive	1
ice cube	ice cube	1
sushi rice	sushi rice	1
lasagne noodles	lasagne noodles	1
cage eggs	cage eggs	1
root beer	root beer	1
savoy cabbage	savoy cabbage	1
anise	anise	1
tart shells	tart shells	1
poblano pepper	poblano pepper	1
sardines	sardines	1
whiz	whiz	1
brazil nuts	brazil nuts	1
spaghetti noodles	spaghetti noodles	1
tomato passata	tomato passata	1
polish sausage	polish sausage	1
wheat spaghetti	wheat spaghetti	1
chocolate milk	chocolate milk	1
whole berry cranberry sauce	whole berry cranberry sauce	1
ham bone	ham bone	1
monosodium glutamate	monosodium glutamate	1
stout	stout	1
wheat hamburger buns	wheat hamburger buns	1
dashi	dashi	1
lg. bell pepper	lg . bell pepper	1
red chili pepper flakes	red chili pepper flakes	1
matcha green tea powder	matcha green tea powder	1
preserves	preserves	1
cilantro parsley	cilantro parsley	1
dog bun	dog bun	1
ripe banana	ripe banana	1
t sugar	t sugar	1
water hot	water hot	1
currant jelly	currant jelly	1
cheese ravioli	cheese ravioli	1
campari	campari	1
jalapeã±o peppers	jalapeã ± o peppers	1
parchment paper	parchment paper	1
boter	boter	1
mint mint	mint mint	1
instant potato flakes	instant potato flakes	1
white karo	white karo	1
relish	relish	1
red beets	red beets	1
nutmeats	nutmeats	1
red chile	red chile	1
mix	mix	1
mexicorn	mexicorn	1
zwiebeln	zwiebeln	1
chicken stock broth	chicken stock broth	1
beet	beet	1
calamari	calamari	1
beef steak	beef steak	1
anise extract	anise extract	1
turbinado sugar	turbinado sugar	1
campbell's real stock chicken	campbell 's real stock chicken	1
melted shortening	melted shortening	1
filet	filet	1
paper	paper	1
corn kernel	corn kernel	1
onion juice	onion juice	1
lean hamburger	lean hamburger	1
neufchatel cheese	neufchatel cheese	1
rice cereal	rice cereal	1
white hominy	white hominy	1
carnation milk	carnation milk	1
sweet chilli sauce	sweet chilli sauce	1
roasting chickens	roasting chickens	1
base	base	1
sambal ulek	sambal ulek	1
beef sirloin steak	beef sirloin steak	1
tl salz	tl salz	1
rub	rub	1
spring roll wrappers	spring roll wrappers	1
rum flavoring	rum flavoring	1
plain whole-milk yogurt	plain whole-milk yogurt	1
pepperoncini	pepperoncini	1
finely celery	finely celery	1
cream of mushroom	cream of mushroom	1
serrano chiles	serrano chiles	1
el zucker	el zucker	1
instant chocolate pudding	instant chocolate pudding	1
wheat berries	wheat berries	1
jellied cranberry sauce	jellied cranberry sauce	1
lemon pudding	lemon pudding	1
crabs	crabs	1
melted butter	melted butter	1
cayenne powder	cayenne powder	1
large shrimp	large shrimp	1
pineapple preserves	pineapple preserves	1
fresh-ground black pepper	fresh-ground black pepper	1
garden peas	garden peas	1
parsley parsley	parsley parsley	1
tomato salsa	tomato salsa	1
lemon lemon juice	lemon lemon juice	1
sourdough	sourdough	1
cracker	cracker	1
pudding	pudding	1
liquid egg substitute	liquid egg substitute	1
cocktail sauce	cocktail sauce	1
gelatin dessert	gelatin dessert	1
potato flour	potato flour	1
ancho chiles	ancho chiles	1
chocolate sprinkles	chocolate sprinkles	1
madras curry powder	madras curry powder	1
baker's angel flake coconut	baker 's angel flake coconut	1
egg white, lightly beaten	egg white , lightly beaten	1
southern comfort	southern comfort	1
bran flakes	bran flakes	1
refrigerated buttermilk biscuits	refrigerated buttermilk biscuits	1
seasoned pepper	seasoned pepper	1
veg-all	veg-all	1
caviar	caviar	1
calumet baking powder	calumet baking powder	1
orange gelatin	orange gelatin	1
jalapeno chile	jalapeno chile	1
porcini mushrooms	porcini mushrooms	1
rump roast	rump roast	1
water chestnut	water chestnut	1
dill dill	dill dill	1
spinach spinach	spinach spinach	1
white tuna	white tuna	1
nonfat buttermilk	nonfat buttermilk	1
slab bacon	slab bacon	1
panko bread crumbs	panko bread crumbs	1
fullcoconut milk	fullcoconut milk	1
bread crumb	bread crumb	1
buttermilk baking mix	buttermilk baking mix	1
beef round steak	beef round steak	1
rice paper	rice paper	1
italian salad dressing	italian salad dressing	1
red quinoa	red quinoa	1
eggs beaten	eggs beaten	1
french onion soup	french onion soup	1
baking chocolate	baking chocolate	1
neufchã¢tel	neufchã ¢ tel	1
light molasses	light molasses	1
coconut flavoring	coconut flavoring	1
aleppo pepper	aleppo pepper	1
turkey broth	turkey broth	1
cms ginger	cms ginger	1
flatbread	flatbread	1
squares chocolate	squares chocolate	1
burger buns	burger buns	1
grill seasoning	grill seasoning	1
green enchilada sauce	green enchilada sauce	1
pita breads	pita breads	1
baby lima beans	baby lima beans	1
serrano chilies	serrano chilies	1
teas	teas	1
crawfish tails	crawfish tails	1
oriental sesame oil	oriental sesame oil	1
mixed mushrooms	mixed mushrooms	1
walnut halves	walnut halves	1
lemon thyme	lemon thyme	1
kraft singles	kraft singles	1
bagels	bagels	1
diced tomatoes	diced tomatoes	1
romaine lettuce leaves	romaine lettuce leaves	1
italian herb seasoning	italian herb seasoning	1
free half and half	free half and half	1
reduced sodium chicken broth	reduced sodium chicken broth	1
curd cottage cheese	curd cottage cheese	1
gochujang base	gochujang base	1
reducedmilk	reducedmilk	1
guajillo chiles	guajillo chiles	1
garlic cloves	garlic cloves	1
urad dal	urad dal	1
green cardamom	green cardamom	1
eetlepels olijfolie	eetlepels olijfolie	1
ciabatta rolls	ciabatta rolls	1
. chicken	. chicken	1
teentje knoflook	teentje knoflook	1
spareribs	spareribs	1
rapeseed oil	rapeseed oil	1
lg. carton cool whip	lg . carton cool whip	1
buttermilk biscuits	buttermilk biscuits	1
lg.	lg .	1
dijon style mustard	dijon style mustard	1
zitrone	zitrone	1
italian tomatoes	italian tomatoes	1
carton sour cream	carton sour cream	1
mignon	mignon	1
parsley sprigs	parsley sprigs	1
chili-garlic sauce	chili-garlic sauce	1
shiitake mushroom	shiitake mushroom	1
pecorino romano	pecorino romano	1
butter olive oil	butter olive oil	1
ginger beer	ginger beer	1
button mushroom	button mushroom	1
bouillon cube	bouillon cube	1
uien	uien	1
cheese cheese	cheese cheese	1
chicken broth broth	chicken broth broth	1
orecchiette	orecchiette	1
center cut pork chops	center cut pork chops	1
shredded sharp cheese	shredded sharp cheese	1
vegetable juice	vegetable juice	1
wooden skewers	wooden skewers	1
guinness beer	guinness beer	1
sea salt salt	sea salt salt	1
shredded parmesan cheese	shredded parmesan cheese	1
ml wasser	ml wasser	1
sucanat	sucanat	1
baby back ribs	baby back ribs	1
tumeric	tumeric	1
carbonated water	carbonated water	1
uncooked macaroni	uncooked macaroni	1
long grain rice	long grain rice	1
pam cooking spray	pam cooking spray	1
tamarind pulp	tamarind pulp	1
egg roll wraps	egg roll wraps	1
navel orange	navel orange	1
fudge	fudge	1
pkgs. broccoli	pkgs . broccoli	1
red chiles	red chiles	1
rocket	rocket	1
pastry pie	pastry pie	1
portobello mushrooms	portobello mushrooms	1
red leaf lettuce	red leaf lettuce	1
raspberry sherbet	raspberry sherbet	1
shoyu	shoyu	1
flank	flank	1
raw cacao powder	raw cacao powder	1
waxy potatoes	waxy potatoes	1
chinese cabbage	chinese cabbage	1
pork baby back ribs	pork baby back ribs	1
fudge topping	fudge topping	1
quail	quail	1
rice mix	rice mix	1
unsweetened applesauce	unsweetened applesauce	1
toffee	toffee	1
dark-brown sugar	dark-brown sugar	1
brownies	brownies	1
v-8 juice	v- 8 juice	1
. potatoes	. potatoes	1
penne rigate	penne rigate	1
spice cake mix	spice cake mix	1
kraft shredded mzarella cheese	kraft shredded mzarella cheese	1
141/2 stewed tomatoes	141 / 2 stewed tomatoes	1
scallion greens	scallion greens	1
raspberry liqueur	raspberry liqueur	1
lemon yogurt	lemon yogurt	1
candy sprinkles	candy sprinkles	1
11/2 boneless skinless chicken breasts	11 / 2 boneless skinless chicken breasts	1
pearl couscous	pearl couscous	1
lime gelatin	lime gelatin	1
sorghum flour	sorghum flour	1
canning salt	canning salt	1
french rolls	french rolls	1
kirby cucumbers	kirby cucumbers	1
medium shrimp	medium shrimp	1
reduced-fat cream cheese	reduced-fat cream cheese	1
miracle whip salad dressing	miracle whip salad dressing	1
ro-tel tomatoes	ro-tel tomatoes	1
kiwi fruit	kiwi fruit	1
graham cracker	graham cracker	1
orange bitters	orange bitters	1
heath bars	heath bars	1
chipotle chile	chipotle chile	1
condensed cream of celery soup	condensed cream of celery soup	1
lemon wedges, to serve	lemon wedges , to serve	1
hard salami	hard salami	1
soda crackers	soda crackers	1
black tea	black tea	1
ganache	ganache	1
tomate	tomate	1
seltzer	seltzer	1
miniature marshmallow	miniature marshmallow	1
wholemeal flour	wholemeal flour	1
shell macaroni	shell macaroni	1
free yogurt	free yogurt	1
ground meat	ground meat	1
el olijfolie	el olijfolie	1
masala	masala	1
french-fried onions	french-fried onions	1
chex cereal	chex cereal	1
lorbeerblã¤tter	lorbeerblã ¤ tter	1
wide noodles	wide noodles	1
marzipan	marzipan	1
marmalade	marmalade	1
wheat couscous	wheat couscous	1
0.99	0.99	1
peanut sauce	peanut sauce	1
serrano pepper	serrano pepper	1
pie spice	pie spice	1
basil dried	basil dried	1
beef chuck roast	beef chuck roast	1
parmigiano	parmigiano	1
orange slices	orange slices	1
sweet potatoes medium	sweet potatoes medium	1
ritz cracker crumbs	ritz cracker crumbs	1
instant pudding	instant pudding	1
pot roast	pot roast	1
chicken fillets	chicken fillets	1
. round steak	. round steak	1
pkgs. active dry yeast	pkgs . active dry yeast	1
brand milk	brand milk	1
mrs. dash seasoning mix	mrs. dash seasoning mix	1
muskat	muskat	1
pineapple chunk	pineapple chunk	1
nonstick spray	nonstick spray	1
pumpkin pie filling	pumpkin pie filling	1
egg yolks	egg yolks	1
french fried onion rings	french fried onion rings	1
gingersnaps	gingersnaps	1
cardamom powder	cardamom powder	1
chicken tenderloins	chicken tenderloins	1
pie pastry	pie pastry	1
meat tenderizer	meat tenderizer	1
vanilla bean seeds	vanilla bean seeds	1
sambal oelek	sambal oelek	1
fajita seasoning mix	fajita seasoning mix	1
tang	tang	1
whole milk	whole milk	1
marsala	marsala	1
fenugreek leaves	fenugreek leaves	1
chocolate liqueur	chocolate liqueur	1
coarse sea salt	coarse sea salt	1
meringue	meringue	1
baby kale	baby kale	1
cardamon	cardamon	1
sandwich rolls	sandwich rolls	1
chile de arbol	chile de arbol	1
silver tequila	silver tequila	1
boiled eggs	boiled eggs	1
smoked ham hocks	smoked ham hocks	1
semi sweet chocolate chips	semi sweet chocolate chips	1
cacao	cacao	1
chocolate wafers	chocolate wafers	1
kohlrabi	kohlrabi	1
brewed coffee	brewed coffee	1
pasta water	pasta water	1
file powder	file powder	1
29 diced tomatoes	29 diced tomatoes	1
bamboo skewers	bamboo skewers	1
coriander ground	coriander ground	1
chocolate-hazelnut spread	chocolate-hazelnut spread	1
long-grain rice	long-grain rice	1
green capsicum	green capsicum	1
can sliced mushrooms	can sliced mushrooms	1
ml gemã¼sebrã¼he	ml gemã1 ⁄ 4 sebrã1 ⁄ 4 he	1
boiling water	boiling water	1
lager beer	lager beer	1
blackberry jam	blackberry jam	1
fat-free cottage cheese	fat-free cottage cheese	1
olivenã¶l	olivenã ¶ l	1
white distilled vinegar	white distilled vinegar	1
irish cream liqueur	irish cream liqueur	1
creme	creme	1
chocolate bar	chocolate bar	1
butter flavor crisco	butter flavor crisco	1
sweet chocolate	sweet chocolate	1
celery stalks	celery stalks	1
littleneck clams	littleneck clams	1
fren vegetables	fren vegetables	1
water broth	water broth	1
peppermint candy	peppermint candy	1
vegetable bouillon	vegetable bouillon	1
. beef	. beef	1
crushed graham crackers	crushed graham crackers	1
onion onions	onion onions	1
boneless pork loin	boneless pork loin	1
whole tomatoes	whole tomatoes	1
pts strawberries	pts strawberries	1
dark corn syrup	dark corn syrup	1
corn kernels corn	corn kernels corn	1
fett fã¼r die form	fett fã1 ⁄ 4 r die form	1
marinade:	marinade :	1
new potatoes	new potatoes	1
saffron thread	saffron thread	1
rock salt	rock salt	1
crushed corn flakes	crushed corn flakes	1
top sirloin steak	top sirloin steak	1
.	.	1
garnish	garnish	1
breadcrumbs bread	breadcrumbs bread	1
crouton	crouton	1
liter milk	liter milk	1
tomato soup, undiluted	tomato soup , undiluted	1
manicotti	manicotti	1
lawry's seasoned salt	lawry 's seasoned salt	1
black walnuts	black walnuts	1
pancake syrup	pancake syrup	1
lemon pie filling	lemon pie filling	1
baby artichokes	baby artichokes	1
baby portobello mushrooms	baby portobello mushrooms	1
paraffin wax	paraffin wax	1
rosewater	rosewater	1
rotel	rotel	1
tablespoons butter	tablespoons butter	1
cherry peppers	cherry peppers	1
butterscotch morsels	butterscotch morsels	1
rye whiskey	rye whiskey	1
sparkling wine	sparkling wine	1
cooked macaroni	cooked macaroni	1
. water	. water	1
lebanese cucumbers	lebanese cucumbers	1
blueberries blueberries	blueberries blueberries	1
yellow corn	yellow corn	1
quaker oats	quaker oats	1
11/2 boneless skinless chicken thighs	11 / 2 boneless skinless chicken thighs	1
vanilla cake mix	vanilla cake mix	1
11/2 sesame oil	11 / 2 sesame oil	1
baker's semi-sweet chocolate	baker 's semi-sweet chocolate	1
summer savory	summer savory	1
broccoli broccoli	broccoli broccoli	1
gherkins	gherkins	1
beef base	beef base	1
lg. carrot	lg . carrot	1
sausage meat	sausage meat	1
halloumi cheese	halloumi cheese	1
bacon, cooked & crumbled	bacon , cooked & crumbled	1
cotija cheese	cotija cheese	1
soft butter	soft butter	1
steaks	steaks	1
env. dream whip	env . dream whip	1
hazelnut oil	hazelnut oil	1
golden beets	golden beets	1
honey sugar	honey sugar	1
kecap manis	kecap manis	1
creamed cottage cheese	creamed cottage cheese	1
potato soup	potato soup	1
butter extract	butter extract	1
peach nectar	peach nectar	1
psyllium husks	psyllium husks	1
bouillon cubes	bouillon cubes	1
crisp bacon	crisp bacon	1
pickling cucumbers	pickling cucumbers	1
chicken tenderloin	chicken tenderloin	1
curds	curds	1
chocolate cookie crumbs	chocolate cookie crumbs	1
dry pasta	dry pasta	1
pudding mix	pudding mix	1
asafoetida powder	asafoetida powder	1
angel hair pasta	angel hair pasta	1
fenugreek	fenugreek	1
brioche bread	brioche bread	1
planters walnuts	planters walnuts	1
country ham	country ham	1
oil butter	oil butter	1
low-fat milk	low-fat milk	1
frisee	frisee	1
louisiana hot sauce	louisiana hot sauce	1
red cherries	red cherries	1
cookie crumbs	cookie crumbs	1
chili seasoning mix	chili seasoning mix	1
for 0.69	for 0.69	1
ea for 2.99	ea for 2.99	1
yellow corn meal	yellow corn meal	1
brats	brats	1
fren shelled edamame	fren shelled edamame	1
ea for 0.69	ea for 0.69	1
butter cake mix	butter cake mix	1
11/2 dried thyme	11 / 2 dried thyme	1
meat bones	meat bones	1
chocolate wafer	chocolate wafer	1
cocoa powder unsweetened	cocoa powder unsweetened	1
baking spray	baking spray	1
mrs. dash	mrs. dash	1
pork shoulder roast	pork shoulder roast	1
t salt	t salt	1
food cake mix	food cake mix	1
dog buns	dog buns	1
oreos	oreos	1
white cabbage	white cabbage	1
loin pork roast	loin pork roast	1
sun-dried tomatoes in oil	sun-dried tomatoes in oil	1
soft cream cheese	soft cream cheese	1
tartar sauce	tartar sauce	1
heinz chili sauce	heinz chili sauce	1
fl milk	fl milk	1
ricotta salata	ricotta salata	1
broccoli slaw	broccoli slaw	1
agave syrup	agave syrup	1
green apples	green apples	1
red capsicums	red capsicums	1
lime slices	lime slices	1
pork cutlets	pork cutlets	1
bocconcini	bocconcini	1
shortbread cookies	shortbread cookies	1
black bean sauce	black bean sauce	1
quick-cooking barley	quick-cooking barley	1
deggs	deggs	1
prosecco	prosecco	1
cream of potato soup	cream of potato soup	1
paraffin	paraffin	1
angel food cake mix	angel food cake mix	1
cherry tomatoes tomatoes	cherry tomatoes tomatoes	1
pt. milk	pt . milk	1
non-fat sour cream	non-fat sour cream	1
chicken breast halves, boneless, skinless	chicken breast halves , boneless , skinless	1
unsalted peanuts	unsalted peanuts	1
garlic pepper seasoning	garlic pepper seasoning	1
orange, juice of	orange , juice of	1
brown onions	brown onions	1
portobello caps	portobello caps	1
carrot juice	carrot juice	1
courgette	courgette	1
essencefollows	essencefollows	1
bay seasoning	bay seasoning	1
red chile peppers	red chile peppers	1
mortadella	mortadella	1
custard	custard	1
scotch whisky	scotch whisky	1
balsamic reduction	balsamic reduction	1
persimmon pulp	persimmon pulp	1
idaho potatoes	idaho potatoes	1
cream style cottage cheese	cream style cottage cheese	1
garlic oil	garlic oil	1
flax	flax	1
chilischote	chilischote	1
light beer	light beer	1
seasoned flour	seasoned flour	1
sesame	sesame	1
chestnut mushrooms	chestnut mushrooms	1
guar gum	guar gum	1
cornflake crumbs	cornflake crumbs	1
gluten free all purpose flour	gluten free all purpose flour	1
orange jell-o	orange jell-o	1
lump crab meat	lump crab meat	1
lg. green pepper	lg . green pepper	1
fig jam	fig jam	1
liquid sweetener	liquid sweetener	1
kabocha squash	kabocha squash	1
unflavored gelatin	unflavored gelatin	1
gluten-free oat	gluten-free oat	1
jar marinated artichoke hearts	jar marinated artichoke hearts	1
ham hocks	ham hocks	1
ginger juice	ginger juice	1
low-fat cottage cheese	low-fat cottage cheese	1
quinoa flour	quinoa flour	1
habanero	habanero	1
honeydew	honeydew	1
ciabatta bread	ciabatta bread	1
cherry gelatin	cherry gelatin	1
lavender flowers	lavender flowers	1
lg. strawberry jello	lg . strawberry jello	1
jiffy cornbread mix	jiffy cornbread mix	1
jalapeno chiles	jalapeno chiles	1
white creme de cacao	white creme de cacao	1
lamb loin chops	lamb loin chops	1
dark karo syrup	dark karo syrup	1
60ml olive oil	60 ml olive oil	1
chocolate pieces	chocolate pieces	1
fat-free low-sodium chicken broth	fat-free low-sodium chicken broth	1
instant polenta	instant polenta	1
buttercream frosting	buttercream frosting	1
mzarella cheese shredded	mzarella cheese shredded	1
dijon	dijon	1
anaheim chile	anaheim chile	1
jaggery	jaggery	1
aubergine	aubergine	1
shrimp shrimp	shrimp shrimp	1
goat's cheese	goat 's cheese	1
cube steaks	cube steaks	1
smoked trout	smoked trout	1
seasoned breadcrumbs	seasoned breadcrumbs	1
reduced-calorie margarine	reduced-calorie margarine	1
sesame seed oil	sesame seed oil	1
nigella seeds	nigella seeds	1
chocolate cake	chocolate cake	1
kiwifruit	kiwifruit	1
jet-puffed miniature marshmallows	jet-puffed miniature marshmallows	1
pink salmon	pink salmon	1
crushed pretzels	crushed pretzels	1
butter unsalted	butter unsalted	1
honeydew melon	honeydew melon	1
milk cream	milk cream	1
lime sherbet	lime sherbet	1
purple onion small	purple onion small	1
blue curacao	blue curacao	1
swordfish steaks	swordfish steaks	1
gelatin powder	gelatin powder	1
free greek yogurt	free greek yogurt	1
snow pea pods	snow pea pods	1
chocolate graham crackers	chocolate graham crackers	1
rye	rye	1
cheddar cheese cheese	cheddar cheese cheese	1
lemon lemon le-mon oval	lemon lemon le-mon oval	1
apple brandy	apple brandy	1
crushed red pepper flakes	crushed red pepper flakes	1
franks	franks	1
chickpeas cooked	chickpeas cooked	1
asparagus tips	asparagus tips	1
gold medal all purpose flour	gold medal all purpose flour	1
day old bread	day old bread	1
herb	herb	1
karo	karo	1
for 4.00	for 4	1
turkey gravy	turkey gravy	1
english cucumbers	english cucumbers	1
chocolate chip cookies	chocolate chip cookies	1
fillets	fillets	1
candy corn	candy corn	1
pace picante sauce	pace picante sauce	1
shallots onions	shallots onions	1
quinces	quinces	1
french fries	french fries	1
meringue powder	meringue powder	1
asafoetida	asafoetida	1
instant espresso	instant espresso	1
hershey bars	hershey bars	1
muffin	muffin	1
edamame beans	edamame beans	1
pepperoni slices	pepperoni slices	1
kool-aid	kool-aid	1
shavings	shavings	1
cracked wheat	cracked wheat	1
slice	slice	1
olijfolie	olijfolie	1
chicken gravy	chicken gravy	1
watercress leaves	watercress leaves	1
crisp rice cereal	crisp rice cereal	1
schalotte	schalotte	1
mesclun	mesclun	1
dry lentils	dry lentils	1
popped corn	popped corn	1
turkey breast cutlets	turkey breast cutlets	1
cane syrup	cane syrup	1
margarine melted	margarine melted	1
for the filling:	for the filling :	1
bread rolls	bread rolls	1
fresco	fresco	1
cheese spread	cheese spread	1
semi-sweet chocolate baking squares	semi-sweet chocolate baking squares	1
seasoned stuffing mix	seasoned stuffing mix	1
151/2 black beans	151 / 2 black beans	1
pistachio pudding mix	pistachio pudding mix	1
cheese sauce	cheese sauce	1
unbleached flour	unbleached flour	1
italian seasoned bread crumbs	italian seasoned bread crumbs	1
bulk italian sausag	bulk italian sausag	1
seasoning mix	seasoning mix	1
t. butter	t. butter	1
ranch salad dressing mix	ranch salad dressing mix	1
nutmeg ground	nutmeg ground	1
baking chips	baking chips	1
wheat chex	wheat chex	1
tagliatelle	tagliatelle	1
broccoli cuts	broccoli cuts	1
coarsely nuts	coarsely nuts	1
naan	naan	1
ginger-garlic paste	ginger-garlic paste	1
vanilla pod	vanilla pod	1
wheat pasta	wheat pasta	1
manicotti shells	manicotti shells	1
anise seeds	anise seeds	1
prise zucker	prise zucker	1
green plantains	green plantains	1
coy-monterey jack cheese	coy-monterey jack cheese	1
challa	challa	1
pineapple slices	pineapple slices	1
batter	batter	1
bund schnittlauch	bund schnittlauch	1
habanero peppers	habanero peppers	1
salmon fillet	salmon fillet	1
cream of chicken soup, undiluted	cream of chicken soup , undiluted	1
x flour	x flour	1
stale bread	stale bread	1
ml oil	ml oil	1
prosciutto ham	prosciutto ham	1
pkgs.	pkgs .	1
flaky sea salt	flaky sea salt	1
natural yoghurt	natural yoghurt	1
mixed peel	mixed peel	1
za'atar	za 'atar	1
heath candy bars	heath candy bars	1
cloves garlic	cloves garlic	1
green pea	green pea	1
chicken breast half	chicken breast half	1
farmer cheese	farmer cheese	1
carrot carrot orange colour	carrot carrot orange colour	1
tenen knoflook	tenen knoflook	1
rice rice	rice rice	1
pt. cream	pt . cream	1
real butter	real butter	1
plum	plum	1
butter chips	butter chips	1
red chili flakes	red chili flakes	1
peanut butter chips	peanut butter chips	1
rigatoni pasta	rigatoni pasta	1
. carrots	. carrots	1
coy jack cheese	coy jack cheese	1
light margarine	light margarine	1
medal flour	medal flour	1
salt, pepper to taste	salt , pepper to taste	1
amaretti cookies	amaretti cookies	1
gingersnap	gingersnap	1
sea bass fillets	sea bass fillets	1
sliced zucchini	sliced zucchini	1
baby shrimp	baby shrimp	1
muskatnuss	muskatnuss	1
chicken thigh	chicken thigh	1
kalamata olive	kalamata olive	1
black peppercorn	black peppercorn	1
irish cream	irish cream	1
celery flakes	celery flakes	1
garlic sauce	garlic sauce	1
ziti pasta	ziti pasta	1
raisin	raisin	1
purple onion medium	purple onion medium	1
stuffed olives	stuffed olives	1
crispy bacon	crispy bacon	1
mango nectar	mango nectar	1
tl zucker	tl zucker	1
mazola oil	mazola oil	1
hamburg	hamburg	1
pork fillets	pork fillets	1
for 3.00	for 3	1
top round steak	top round steak	1
canola oil cooking spray	canola oil cooking spray	1
small red potatoes	small red potatoes	1
vegetable bouillon cube	vegetable bouillon cube	1
red apples	red apples	1
cooking apples	cooking apples	1
hard cheese	hard cheese	1
special k cereal	special k cereal	1
black vinegar	black vinegar	1
mackerel	mackerel	1
liter vegetable stock	liter vegetable stock	1
powder	powder	1
merlot	merlot	1
hershey's syrup	hershey 's syrup	1
peach pie filling	peach pie filling	1
blue curaã§ao	blue curaã § ao	1
yellow	yellow	1
cranberries cranberries	cranberries cranberries	1
toppings	toppings	1
glace cherries	glace cherries	1
ghee oil	ghee oil	1
pistachio instant pudding	pistachio instant pudding	1
milnot	milnot	1
pastry shells	pastry shells	1
icing:	icing :	1
red radishes	red radishes	1
reduced	reduced	1
grape tomatoes	grape tomatoes	1
g parmesan	g parmesan	1
graham cracker crusts	graham cracker crusts	1
pouring cream	pouring cream	1
lemon-pepper seasoning	lemon-pepper seasoning	1
slider buns	slider buns	1
g kartoffeln	g kartoffeln	1
corn bread	corn bread	1
cayenne pepper sauce	cayenne pepper sauce	1
corn mix muffin	corn mix muffin	1
corn chex	corn chex	1
garlic paste ginger	garlic paste ginger	1
kleine zwiebel	kleine zwiebel	1
provolone	provolone	1
mahi mahi fillets	mahi mahi fillets	1
roma tomato	roma tomato	1
grated monterey jack cheese	grated monterey jack cheese	1
black beans beans	black beans beans	1
chocolate candy bars	chocolate candy bars	1
vegetable broth chicken broth	vegetable broth chicken broth	1
whole grain dijon mustard	whole grain dijon mustard	1
red chile flakes	red chile flakes	1
pt. vinegar	pt . vinegar	1
fast rising yeast	fast rising yeast	1
lower sodium soy sauce	lower sodium soy sauce	1
egg egg egg the ultimate convenience food	egg egg egg the ultimate convenience food	1
dutch-process cocoa powder	dutch-process cocoa powder	1
artichoke heart	artichoke heart	1
beef flank steak	beef flank steak	1
red snapper fillets	red snapper fillets	1
pepper jack cheese	pepper jack cheese	1
flat-leaf parsley	flat-leaf parsley	1
date	date	1
tawny port	tawny port	1
iron	iron	1
goji berries	goji berries	1
espresso coffee	espresso coffee	1
mung beans	mung beans	1
sirloin steaks	sirloin steaks	1
serrano ham	serrano ham	1
crema	crema	1
baking potatoes large	baking potatoes large	1
parsley leaves minced	parsley leaves minced	1
xylitol sweetener	xylitol sweetener	1
liver	liver	1
kraft	kraft	1
baguette bread	baguette bread	1
tbs butter	tbs butter	1
multigrain bread	multigrain bread	1
bass	bass	1
spring greens	spring greens	1
sugar splenda sugar substitute	sugar splenda sugar substitute	1
edible flowers	edible flowers	1
wild mushrooms	wild mushrooms	1
celeriac	celeriac	1
monterey	monterey	1
chocolate kisses	chocolate kisses	1
fren hash browns	fren hash browns	1
consomme	consomme	1
anjou pears	anjou pears	1
chicken broth vegetable broth	chicken broth vegetable broth	1
ribbon	ribbon	1
for 1.99	for 1.99	1
unsulphured molasses	unsulphured molasses	1
gari	gari	1
tarragon tarragon	tarragon tarragon	1
lady fingers	lady fingers	1
blue cheese dressing	blue cheese dressing	1
red lentil	red lentil	1
lea & perrins worcestershire sauce	lea & perrins worcestershire sauce	1
el	el	1
light coconut milk	light coconut milk	1
meal	meal	1
mexican cheese	mexican cheese	1
colouring	colouring	1
green grape	green grape	1
soy yogurt	soy yogurt	1
crispy rice cereal	crispy rice cereal	1
beet juice	beet juice	1
red salmon	red salmon	1
liters ginger ale	liters ginger ale	1
dry basil	dry basil	1
g crã¨me fraã®che	g crã ̈me fraã ® che	1
lime wedge	lime wedge	1
apples apples	apples apples	1
chili paste garlic	chili paste garlic	1
green creme de menthe	green creme de menthe	1
cornbread stuffing mix	cornbread stuffing mix	1
chocolate unsweetened	chocolate unsweetened	1
sweetened condensed milk	sweetened condensed milk	1
gluten free blend	gluten free blend	1
liquid smoke flavoring	liquid smoke flavoring	1
mangos	mangos	1
ml sahne	ml sahne	1
lean bacon	lean bacon	1
vanilla wafer	vanilla wafer	1
seaweed	seaweed	1
butter cooking spray	butter cooking spray	1
lg. tomato	lg . tomato	1
goose	goose	1
el honig	el honig	1
tart	tart	1
pkg taco seasoning	pkg taco seasoning	1
duncan hines yellow cake mix	duncan hines yellow cake mix	1
shortening oil	shortening oil	1
olive oil butter	olive oil butter	1
oxtails	oxtails	1
lasagna	lasagna	1
sun-dried tomatoes oil	sun-dried tomatoes oil	1
pasilla chiles	pasilla chiles	1
filo pastry	filo pastry	1
star anise pods	star anise pods	1
harissa paste	harissa paste	1
very warm water	very warm water	1
ripe avocado	ripe avocado	1
sweet hungarian paprika	sweet hungarian paprika	1
envelope onion soup mix	envelope onion soup mix	1
grenadine syrup	grenadine syrup	1
butter shortening	butter shortening	1
galliano	galliano	1
dried leaves oregano	dried leaves oregano	1
white corn tortillas	white corn tortillas	1
arrowroot starch	arrowroot starch	1
soup, cream of mushroom	soup , cream of mushroom	1
103/4 cream of celery soup	103 / 4 cream of celery soup	1
kraft shredded parmesan cheese	kraft shredded parmesan cheese	1
el sojasauce	el sojasauce	1
ale	ale	1
french lentils	french lentils	1
maraschino cherry juice	maraschino cherry juice	1
porcini	porcini	1
ramps	ramps	1
petite peas	petite peas	1
corn tortilla	corn tortilla	1
beef shank	beef shank	1
chicken soup base	chicken soup base	1
gingersnap crumbs	gingersnap crumbs	1
mayonaise	mayonaise	1
lemon twists	lemon twists	1
celery heart	celery heart	1
x nonstick cooking spray	x nonstick cooking spray	1
unbleached all-purpose flour	unbleached all-purpose flour	1
vanilla flavor	vanilla flavor	1
dill sprigs	dill sprigs	1
cod fillets	cod fillets	1
coconut nectar	coconut nectar	1
bread crumbs bread	bread crumbs bread	1
corn-on-the-cob	corn-on-the-cob	1
carton cottage cheese	carton cottage cheese	1
t pepper	t pepper	1
low-fat sour cream	low-fat sour cream	1
grape leaves	grape leaves	1
udon	udon	1
prune	prune	1
pkg yeast	pkg yeast	1
egg white	egg white	1
refrigerated pizza dough	refrigerated pizza dough	1
pork mince	pork mince	1
cracker meal	cracker meal	1
chicken bouillon powder	chicken bouillon powder	1
toothpick	toothpick	1
light muscovado sugar	light muscovado sugar	1
cornish game hens	cornish game hens	1
caramel	caramel	1
green prawns	green prawns	1
dough:	dough :	1
espresso beans	espresso beans	1
garlic chives	garlic chives	1
chicken chicken breasts	chicken chicken breasts	1
english cheese	english cheese	1
turnip greens	turnip greens	1
lasagna sheets	lasagna sheets	1
sweet pickle juice	sweet pickle juice	1
apple sauce	apple sauce	1
07/02	7 / 2	1
shrimp stock	shrimp stock	1
fresh cilantro	fresh cilantro	1
water milk	water milk	1
oregano dried	oregano dried	1
butter/butter	butter / butter	1
ripe bananas	ripe bananas	1
mayonnaise salad dressing	mayonnaise salad dressing	1
whole wheat flour	whole wheat flour	1
parsley sprig	parsley sprig	1
baileys irish cream	baileys irish cream	1
runny honey	runny honey	1
1-1/2	1 -1 / 2	1
cheesecake	cheesecake	1
pure cream	pure cream	1
bonito flakes	bonito flakes	1
cheese soup	cheese soup	1
sea bass	sea bass	1
niã§oise olives	niã § oise olives	1
peas peas	peas peas	1
turkey beef	turkey beef	1
shredded low-fat cheddar cheese	shredded low-fat cheddar cheese	1
turkey kieasa	turkey kieasa	1
brussels sprout	brussels sprout	1
mandarin orange segments	mandarin orange segments	1
yellow onion large	yellow onion large	1
horseradish cream	horseradish cream	1
won ton wrappers	won ton wrappers	1
lard oil	lard oil	1
shallot onion	shallot onion	1
amchur	amchur	1
corn niblets	corn niblets	1
green split peas	green split peas	1
hollandaise sauce	hollandaise sauce	1
chick-peas	chick-peas	1
seafood cocktail sauce	seafood cocktail sauce	1
lg. cucumbers	lg . cucumbers	1
fren corn	fren corn	1
heavy	heavy	1
all bran cereal	all bran cereal	1
quickcooking grits	quickcooking grits	1
cansliced black olives	cansliced black olives	1
braggs liquid aminos	braggs liquid aminos	1
rump steak	rump steak	1
raisin bread	raisin bread	1
butter crackers	butter crackers	1
limeade concentrate	limeade concentrate	1
rapid rise yeast	rapid rise yeast	1
large eggs	large eggs	1
kiwis	kiwis	1
packung	packung	1
portobello mushroom caps	portobello mushroom caps	1
shell pasta	shell pasta	1
herb stuffing mix	herb stuffing mix	1
250 cream cheese	250 cream cheese	1
barley flour	barley flour	1
garam masala powder	garam masala powder	1
duck breast	duck breast	1
broccoli flowerettes	broccoli flowerettes	1
whip cream	whip cream	1
boiled ham	boiled ham	1
white cheese	white cheese	1
pasta pasta	pasta pasta	1
epazote	epazote	1
citroen	citroen	1
bologna	bologna	1
fire tomatoes	fire tomatoes	1
cherry jell-o	cherry jell-o	1
garnish:	garnish :	1
spaghettini	spaghettini	1
stevia powder	stevia powder	1
food gel	food gel	1
zucchinis	zucchinis	1
thin cream	thin cream	1
small curd cottage cheese	small curd cottage cheese	1
50 parmesan cheese	50 parmesan cheese	1
brown gravy	brown gravy	1
chorizo sausages	chorizo sausages	1
stove top stuffing	stove top stuffing	1
g boter	g boter	1
lg. celery	lg . celery	1
almond bark	almond bark	1
t flour	t flour	1
tamarind	tamarind	1
sweet bell peppers	sweet bell peppers	1
dried mexican oregano	dried mexican oregano	1
fudge sauce	fudge sauce	1
for	for	1
vinegar vinegar	vinegar vinegar	1
buckwheat groats	buckwheat groats	1
vegetable soup	vegetable soup	1
wonton skins	wonton skins	1
italian dressing	italian dressing	1
purple onion large	purple onion large	1
red wine dry	red wine dry	1
green tea bags	green tea bags	1
chicken liver	chicken liver	1
pork steaks	pork steaks	1
env.	env .	1
white pearl onions	white pearl onions	1
velveetaâ®	velveetaâ ®	1
orange food coloring	orange food coloring	1
brown basmati rice	brown basmati rice	1
vidalia onions	vidalia onions	1
blackberry	blackberry	1
green bell peppers diced	green bell peppers diced	1
aioli	aioli	1
buffalo meat	buffalo meat	1
beau monde seasoning	beau monde seasoning	1
soda water	soda water	1
garlic crushed	garlic crushed	1
kraft classic ranch dressing	kraft classic ranch dressing	1
light sour cream	light sour cream	1
cherry brandy	cherry brandy	1
refrigerator biscuits	refrigerator biscuits	1
condensed cream of mushroom soup undiluted	condensed cream of mushroom soup undiluted	1
flounder fillets	flounder fillets	1
coca cola	coca cola	1
red pepper flakes crushed	red pepper flakes crushed	1
g magerquark	g magerquark	1
peppermint oil	peppermint oil	1
citric acid	citric acid	1
dumplings	dumplings	1
25g butter butter	25 g butter butter	1
chicken-flavored soup powder	chicken-flavored soup powder	1
garlic granules	garlic granules	1
diced green chilies	diced green chilies	1
pillsbury crescent rolls	pillsbury crescent rolls	1
chicken stock cube	chicken stock cube	1
strawberry yogurt	strawberry yogurt	1
beef sausage	beef sausage	1
celery diced	celery diced	1
sage leaf	sage leaf	1
dill tips	dill tips	1
lorbeerblatt	lorbeerblatt	1
graham flour	graham flour	1
chayotes	chayotes	1
sparkling water	sparkling water	1
seafood	seafood	1
scotch	scotch	1
popped popcorn	popped popcorn	1
chicken bouillon granule	chicken bouillon granule	1
crab boil	crab boil	1
dry active yeast	dry active yeast	1
mexican oregano	mexican oregano	1
shrimp soup	shrimp soup	1
raw cashews	raw cashews	1
sweet sherry	sweet sherry	1
single cream	single cream	1
almond liqueur	almond liqueur	1
vanilla almondmilk	vanilla almondmilk	1
ml orange juice	ml orange juice	1
tzatziki sauce	tzatziki sauce	1
delicata squash	delicata squash	1
blackstrap molasses	blackstrap molasses	1
brie	brie	1
romaine lettuce hearts	romaine lettuce hearts	1
cream of chicken	cream of chicken	1
italian parsley leaves	italian parsley leaves	1
spears asparagus	spears asparagus	1
lasagne	lasagne	1
pickle	pickle	1
creamer	creamer	1
piquillo peppers	piquillo peppers	1
flank steaks	flank steaks	1
rotel tomatoes & chilies	rotel tomatoes & chilies	1
baby rocket leaves	baby rocket leaves	1
chives onions	chives onions	1
mixed dried fruit	mixed dried fruit	1
jalapeã±os	jalapeã ± os	1
french mustard	french mustard	1
cracker crumb	cracker crumb	1
nut butter	nut butter	1
tl backpulver	tl backpulver	1
basil fresh	basil fresh	1
pumpkin pumpkin	pumpkin pumpkin	1
pretzel twists	pretzel twists	1
ras el hanout	ras el hanout	1
nilla wafers	nilla wafers	1
crispix cereal	crispix cereal	1
a-1 sauce	a- 1 sauce	1
instant chocolate pudding mix	instant chocolate pudding mix	1
hazelnut liqueur	hazelnut liqueur	1
hot dog buns	hot dog buns	1
breakfast sausage	breakfast sausage	1
cinnamon candies	cinnamon candies	1
green tea powder	green tea powder	1
whole-kernel corn	whole-kernel corn	1
sage sage	sage sage	1
zest	zest	1
green	green	1
1/3-less-fat cream cheese	1 / 3 -less-fat cream cheese	1
fruit pectin	fruit pectin	1
sour mix	sour mix	1
ritz cracker	ritz cracker	1
lg. mushrooms	lg . mushrooms	1
knox gelatin	knox gelatin	1
11/2 fresh thyme	11 / 2 fresh thyme	1
mushrooms fresh	mushrooms fresh	1
guinness stout	guinness stout	1
pear nectar	pear nectar	1
chocolate cocoa powder	chocolate cocoa powder	1
honey dijon mustard	honey dijon mustard	1
papayas	papayas	1
en zout	en zout	1
cinnamon graham crackers	cinnamon graham crackers	1
pastrami	pastrami	1
pencil	pencil	1
drippings	drippings	1
g mã¶hren	g mã ¶ hren	1
leaf lettuce	leaf lettuce	1
red currants	red currants	1
jell-o	jell-o	1
snapper	snapper	1
russet potatoes large	russet potatoes large	1
bay leaf dried	bay leaf dried	1
campbell's cream of mushroom soup	campbell 's cream of mushroom soup	1
unbaked 9 inch pie shell	unbaked 9 inch pie shell	1
dry oregano	dry oregano	1
groãe zwiebel	groã  e zwiebel	1
pt. cottage cheese	pt . cottage cheese	1
macaroni noodles	macaroni noodles	1
turkey breast deli meat	turkey breast deli meat	1
rode paprika	rode paprika	1
gumdrops	gumdrops	1
jar pimentos	jar pimentos	1
el butterschmalz	el butterschmalz	1
condensed golden mushroom soup	condensed golden mushroom soup	1
ginger ale, chilled	ginger ale , chilled	1
t. sugar	t. sugar	1
mzarella balls	mzarella balls	1
sugar white	sugar white	1
fresh tarragon	fresh tarragon	1
instant pudding mix	instant pudding mix	1
instant white rice	instant white rice	1
ml crã¨me fraã®che	ml crã ̈me fraã ® che	1
pepperoncini peppers	pepperoncini peppers	1
biscuit dough	biscuit dough	1
jar pimientos	jar pimientos	1
flour tortillas large	flour tortillas large	1
unsalted butter butter	unsalted butter butter	1
sqs. chocolate	sqs . chocolate	1
white almond bark	white almond bark	1
bean dip	bean dip	1
monkfish	monkfish	1
grape-nuts cereal	grape-nuts cereal	1
daikon radish	daikon radish	1
decorating sugars	decorating sugars	1
rice cooked	rice cooked	1
7 up	7 up	1
151/4 whole kernel corn	151 / 4 whole kernel corn	1
sandwiches	sandwiches	1
for 4.99	for 4.99	1
canola	canola	1
turkey cutlets	turkey cutlets	1
beef liver	beef liver	1
salt substitute	salt substitute	1
truvã­aâ® natural sweetener	truvã ­ aâ ® natural sweetener	1
crusty rolls	crusty rolls	1
spanish rice	spanish rice	1
fraã®che	fraã ® che	1
g schmand	g schmand	1
paneer	paneer	1
jerk seasoning	jerk seasoning	1
rose petals	rose petals	1
&nbsp	& nbsp	1
lemon pudding mix	lemon pudding mix	1
vanilla bean ice cream	vanilla bean ice cream	1
fuji apple	fuji apple	1
plain chocolate	plain chocolate	1
grainy mustard	grainy mustard	1
whipped cream cream	whipped cream cream	1
soft shortening	soft shortening	1
udon noodles	udon noodles	1
herb seasoning	herb seasoning	1
en peper	en peper	1
egg yolks, at room temperature	egg yolks , at room temperature	1
lemon jell-o gelatin	lemon jell-o gelatin	1
pepperidge farm stuffing mix	pepperidge farm stuffing mix	1
. cucumbers	. cucumbers	1
orange blossom water	orange blossom water	1
. meat	. meat	1
chili seasoning	chili seasoning	1
uncooked noodles	uncooked noodles	1
celery & leaves	celery & leaves	1
dry mustard powder	dry mustard powder	1
. ginger ale	. ginger ale	1
chuck steak	chuck steak	1
broccoli soup	broccoli soup	1
chambord raspberry liquor	chambord raspberry liquor	1
sponge cake	sponge cake	1
slaw	slaw	1
ginger fresh	ginger fresh	1
banana leaves	banana leaves	1
rotisserie chicken	rotisserie chicken	1
fresno chiles	fresno chiles	1
onions diced	onions diced	1
bamboo shoot	bamboo shoot	1
butterscotch pudding	butterscotch pudding	1
unsalted almonds	unsalted almonds	1
candied fruit	candied fruit	1
bing cherries	bing cherries	1
white	white	1
taco mix	taco mix	1
vanilla low-fat yogurt	vanilla low-fat yogurt	1
crusty bread	crusty bread	1
banana extract	banana extract	1
ravioli	ravioli	1
50g butter butter	50 g butter butter	1
instant lemon pudding	instant lemon pudding	1
instant brown rice	instant brown rice	1
starch	starch	1
garlic and herb seasoning	garlic and herb seasoning	1
gummy worms	gummy worms	1
. stew meat	. stew meat	1
grapeseed oil oil	grapeseed oil oil	1
ouzo	ouzo	1
margarita mix	margarita mix	1
cream mushroom soup	cream mushroom soup	1
bean paste	bean paste	1
raw cranberries	raw cranberries	1
pear juice	pear juice	1
x	x	1
fuyu persimmons	fuyu persimmons	1
portabella mushroom	portabella mushroom	1
ginger syrup	ginger syrup	1
dried savory	dried savory	1
peach juice	peach juice	1
grapefruits	grapefruits	1
almonds slivered	almonds slivered	1
lychees	lychees	1
commercial sour cream	commercial sour cream	1
water juice	water juice	1
m&m's®	m & m 's ®	1
. sausage	. sausage	1
digestive biscuit	digestive biscuit	1
thawed cool whip	thawed cool whip	1
pt. half and half	pt . half and half	1
honey syrup	honey syrup	1
asafetida	asafetida	1
catalina	catalina	1
chardonnay	chardonnay	1
fudge brownie mix	fudge brownie mix	1
lemon instant pudding	lemon instant pudding	1
crumbs bread	crumbs bread	1
non dairy milk	non dairy milk	1
green pepper strips	green pepper strips	1
beef pork	beef pork	1
salt optional	salt optional	1
kraft balsamic vinaigrette dressing	kraft balsamic vinaigrette dressing	1
chicken leg quarters	chicken leg quarters	1
brown	brown	1
instant pistachio pudding	instant pistachio pudding	1
red food color	red food color	1
pkgs. crescent rolls	pkgs . crescent rolls	1
ditalini	ditalini	1
cinnamon rolls	cinnamon rolls	1
beef bones	beef bones	1
env. lipton onion soup mix	env . lipton onion soup mix	1
french cut green beans	french cut green beans	1
lemon juice vinegar	lemon juice vinegar	1
tangerines	tangerines	1
thai basil	thai basil	1
mã¶hre	mã ¶ hre	1
sorrel	sorrel	1
horseradish mustard	horseradish mustard	1
raspberries raspberries	raspberries raspberries	1
dry crushed red pepper	dry crushed red pepper	1
mango juice	mango juice	1
parma ham	parma ham	1
cilantro fresh	cilantro fresh	1
maple sugar	maple sugar	1
hash	hash	1
haas avocados	haas avocados	1
shredded mexican blend cheese	shredded mexican blend cheese	1
sweet mini bells	sweet mini bells	1
dill pickle relish	dill pickle relish	1
red cinnamon candies	red cinnamon candies	1
green chilli	green chilli	1
green chilis	green chilis	1
ginger snaps	ginger snaps	1
crã¨me de menthe	crã ̈me de menthe	1
herbes	herbes	1
orange blossom honey	orange blossom honey	1
quick-cooking grits	quick-cooking grits	1
brine	brine	1
quinoa flakes	quinoa flakes	1
white cooking wine	white cooking wine	1
cool	cool	1
baby portabella mushrooms	baby portabella mushrooms	1
spanish olives	spanish olives	1
seasonings	seasonings	1
mein noodles	mein noodles	1
strawberry jelly	strawberry jelly	1
pkgs. spinach	pkgs . spinach	1
gelatin unflavored	gelatin unflavored	1
quick cooking tapioca	quick cooking tapioca	1
english toffee bits	english toffee bits	1
carbonated lemon-lime beverage	carbonated lemon-lime beverage	1
thai chile	thai chile	1
vanilla ice-cream	vanilla ice-cream	1
chile flakes	chile flakes	1
pkg for 4.99	pkg for 4.99	1
seasoning salt salt	seasoning salt salt	1
pies	pies	1
vanilla wafer cookies	vanilla wafer cookies	1
seafood stock	seafood stock	1
angel food cake	angel food cake	1
fluid vodka	fluid vodka	1
armagnac	armagnac	1
planters sliced almonds	planters sliced almonds	1
low-sodium chicken broth	low-sodium chicken broth	1
kraft parmesan cheese	kraft parmesan cheese	1
cooked spaghetti	cooked spaghetti	1
orange sweet potato	orange sweet potato	1
pink grapefruit juice	pink grapefruit juice	1
starter	starter	1
bleu cheese	bleu cheese	1
loin pork chops	loin pork chops	1
chocolate glaze	chocolate glaze	1
thin spaghetti	thin spaghetti	1
bottle ketchup	bottle ketchup	1
chex	chex	1
wieners	wieners	1
imitation crab meat	imitation crab meat	1
baby beets	baby beets	1
garlic butter	garlic butter	1
bran cereal	bran cereal	1
celtic sea salt	celtic sea salt	1
white mushroom	white mushroom	1
jar pizza sauce	jar pizza sauce	1
pineapple sherbet	pineapple sherbet	1
spanish chorizo	spanish chorizo	1
sweet cream	sweet cream	1
red apple	red apple	1
hardboiled egg	hardboiled egg	1
white tequila	white tequila	1
jerusalem artichokes	jerusalem artichokes	1
matzos	matzos	1
lime wedges, to serve	lime wedges , to serve	1
white horseradish	white horseradish	1
remaining ingredients:	remaining ingredients :	1
vegetable oil spray	vegetable oil spray	1
red miso	red miso	1
roast beef	roast beef	1
semi sweet mini chocolate chips	semi sweet mini chocolate chips	1
dandelion greens	dandelion greens	1
mustard oil	mustard oil	1
pita pockets	pita pockets	1
natural bran	natural bran	1
english muffin	english muffin	1
avocado - peeled	avocado - peeled	1
swede	swede	1
raisin bran cereal	raisin bran cereal	1
phyllo pastry sheets	phyllo pastry sheets	1
dill leaves	dill leaves	1
pickled ginger	pickled ginger	1
x paprika	x paprika	1
puffed rice cereal	puffed rice cereal	1
t cumin	t cumin	1
lawry's salt	lawry 's salt	1
el milch	el milch	1
vegan chocolate chips	vegan chocolate chips	1
sorghum	sorghum	1
green lentils	green lentils	1
pecan nuts	pecan nuts	1
apricot halves	apricot halves	1
turkey wings	turkey wings	1
sweet and sour mix	sweet and sour mix	1
hen	hen	1
free-range eggs	free-range eggs	1
fettucini	fettucini	1
cherry jam	cherry jam	1
pear halves	pear halves	1
sugar honey	sugar honey	1
key lime	key lime	1
vegetable stock chicken stock	vegetable stock chicken stock	1
confectionersâ sugar	confectionersâ   sugar	1
ml champagne	ml champagne	1
shortening butter	shortening butter	1
cremini mushroom	cremini mushroom	1
veal shanks	veal shanks	1
well-shaken buttermilk	well-shaken buttermilk	1
reese's	reese 's	1
pistachio kernels	pistachio kernels	1
parsley dried	parsley dried	1
half-and-half milk	half-and-half milk	1
courgettes	courgettes	1
carrots shredded	carrots shredded	1
cream of shrimp soup	cream of shrimp soup	1
lime juice lemon juice	lime juice lemon juice	1
burrata	burrata	1
flour tortillas 10-inch	flour tortillas 10 -inch	1
coconut flaked	coconut flaked	1
rainbow sprinkles	rainbow sprinkles	1
chicken cooked	chicken cooked	1
green chillies	green chillies	1
sugar cinnamon	sugar cinnamon	1
lamb loin	lamb loin	1
-2 water	-2 water	1
green apple	green apple	1
theelepel zout	theelepel zout	1
poppyseeds	poppyseeds	1
g kirschtomaten	g kirschtomaten	1
beet greens	beet greens	1
jar marinara sauce	jar marinara sauce	1
anchovy filets	anchovy filets	1
dairy milk	dairy milk	1
low-fat cheese	low-fat cheese	1
chambord	chambord	1
tomatillo	tomatillo	1
condiments	condiments	1
red wine vinegar vinegar	red wine vinegar vinegar	1
serrano chile	serrano chile	1
rosemary leaf	rosemary leaf	1
soft margarine	soft margarine	1
baby rocket	baby rocket	1
almond oil	almond oil	1
suiker	suiker	1
14 black beans	14 black beans	1
orange orange	orange orange	1
whey	whey	1
gold potatoes	gold potatoes	1
tomato catsup	tomato catsup	1
chicken rice soup	chicken rice soup	1
israeli couscous	israeli couscous	1
semolina flour	semolina flour	1
asian chili sauce	asian chili sauce	1
wacholderbeeren	wacholderbeeren	1
schnapps	schnapps	1
portabella mushroom caps	portabella mushroom caps	1
beetroot	beetroot	1
cayennepfeffer	cayennepfeffer	1
garlic cheese	garlic cheese	1
star fruit	star fruit	1
dill seeds	dill seeds	1
hazelnut meal	hazelnut meal	1
red raspberries	red raspberries	1
gelatine	gelatine	1
frank's red hot sauce	frank 's red hot sauce	1
jar pimento	jar pimento	1
el paniermehl	el paniermehl	1
ml sugar	ml sugar	1
tomatillo salsa	tomatillo salsa	1
wheat pita	wheat pita	1
half and half cream	half and half cream	1
sugar cookie mix	sugar cookie mix	1
onion finely	onion finely	1
lg. apples	lg . apples	1
black cardamom pods	black cardamom pods	1
feta cheese crumbled	feta cheese crumbled	1
green pepper, cut into strips	green pepper , cut into strips	1
salt/pepper	salt / pepper	1
green chili salsa	green chili salsa	1
chicken soup undiluted	chicken soup undiluted	1
jiffy corn bread mix	jiffy corn bread mix	1
chicken noodle soup	chicken noodle soup	1
heinz ketchup	heinz ketchup	1
broken pecans	broken pecans	1
yeast cake	yeast cake	1
poblano	poblano	1
tbs sugar	tbs sugar	1
tl senf	tl senf	1
dcorn tortillas	dcorn tortillas	1
pheasant	pheasant	1
chinese vegetables	chinese vegetables	1
pork country-style ribs	pork country-style ribs	1
french bread baguette	french bread baguette	1
aniseed	aniseed	1
cake yeast	cake yeast	1
rice bran oil	rice bran oil	1
freshly ground pepper	freshly ground pepper	1
ice cream topping	ice cream topping	1
boneless chicken breasts	boneless chicken breasts	1
champignons	champignons	1
seitan	seitan	1
thai chiles	thai chiles	1
caramel syrup	caramel syrup	1
milk water	milk water	1
bananas,	bananas ,	1
bloem	bloem	1
fresh cream	fresh cream	1
butter-margarine blend	butter-margarine blend	1
vanilla whey protein powder	vanilla whey protein powder	1
sliced peaches	sliced peaches	1
pappardelle	pappardelle	1
kraft mexican style	kraft mexican style	1
chicken chicken	chicken chicken	1
x parmesan, parmigiano-reggiano cheese	x parmesan , parmigiano-reggiano cheese	1
teriyaki marinade	teriyaki marinade	1
min	min	1
string cheese	string cheese	1
demi-glace	demi-glace	1
dry bread	dry bread	1
double-sided tape	double-sided tape	1
louisiana sauce	louisiana sauce	1
dark chocolate cocoa powder	dark chocolate cocoa powder	1
red hots	red hots	1
light tuna	light tuna	1
cheese whiz	cheese whiz	1
for the sauce:	for the sauce :	1
kraft mayonnaise	kraft mayonnaise	1
pita chips	pita chips	1
sugar cubes	sugar cubes	1
vegetable-oil cooking spray	vegetable-oil cooking spray	1
juice lime	juice lime	1
lasagna noodle	lasagna noodle	1
ground veal	ground veal	1
tub whip	tub whip	1
paintbrush	paintbrush	1
pastry cream	pastry cream	1
cocoa mix	cocoa mix	1
lemon juice lime juice	lemon juice lime juice	1
g kã¤se	g kã ¤ se	1
roasting chicken	roasting chicken	1
dose	dose	1
in syrup	in syrup	1
taco chips	taco chips	1
achiote paste	achiote paste	1
black rice	black rice	1
treacle	treacle	1
gold tequila	gold tequila	1
nonfat greek yogurt	nonfat greek yogurt	1
habanero chile	habanero chile	1
large bell pepper	large bell pepper	1
11/2 seasoning salt	11 / 2 seasoning salt	1
chicory	chicory	1
unbeaten egg	unbeaten egg	1
short ribs	short ribs	1
fructose	fructose	1
caribbean jerk seasoning	caribbean jerk seasoning	1
non-fat milk	non-fat milk	1
ham ham	ham ham	1
rabbits	rabbits	1
chilis	chilis	1
jell-o gelatin lemon	jell-o gelatin lemon	1
popsicle	popsicle	1
halves	halves	1
bottle chili sauce	bottle chili sauce	1
shoe peg corn	shoe peg corn	1
cashew butter	cashew butter	1
channa dal	channa dal	1
russet potato	russet potato	1
turkey chicken	turkey chicken	1
splenda granular, sugar substitute	splenda granular , sugar substitute	1
peppermint schnapps	peppermint schnapps	1
dried dill weed	dried dill weed	1
desiccated coconut	desiccated coconut	1
red cabbage, shredded	red cabbage , shredded	1
t black pepper	t black pepper	1
fren peas and carrots	fren peas and carrots	1
rib roast	rib roast	1
sugar cookies	sugar cookies	1
pancetta bacon	pancetta bacon	1
celery sliced	celery sliced	1
rosemary sprig	rosemary sprig	1
corn cobs	corn cobs	1
parmigiano reggiano	parmigiano reggiano	1
pt. half & half	pt . half & half	1
sesame paste	sesame paste	1
choice	choice	1
straw mushrooms	straw mushrooms	1
montreal steak seasoning	montreal steak seasoning	1
apple slices	apple slices	1
uncooked long grain rice	uncooked long grain rice	1
coffee extract	coffee extract	1
yellow summer squash	yellow summer squash	1
agave	agave	1
sweet red bell peppers diced	sweet red bell peppers diced	1
chaat masala	chaat masala	1
passion fruit juice	passion fruit juice	1
instant coffee crystals	instant coffee crystals	1
dill dill weed	dill dill weed	1
vegetable oil olive oil	vegetable oil olive oil	1
unsalted butter oil	unsalted butter oil	1
coffee-flavored liqueur	coffee-flavored liqueur	1
lemon twist	lemon twist	1
pts cherry tomatoes	pts cherry tomatoes	1
turkey carcass	turkey carcass	1
tiny shrimp	tiny shrimp	1
m.-groãe zwiebel	m. -groã  e zwiebel	1
marshmallow	marshmallow	1
chicken broth stock	chicken broth stock	1
0.5	0.5	1
graham cracker squares	graham cracker squares	1
jack daniels whiskey	jack daniels whiskey	1
brown rice vinegar	brown rice vinegar	1
jarlsberg cheese	jarlsberg cheese	1
chives onion	chives onion	1
chicken bones	chicken bones	1
thyme leaves thyme	thyme leaves thyme	1
broiler-fryer chicken	broiler-fryer chicken	1
coriander leaves, to serve	coriander leaves , to serve	1
dry gin	dry gin	1
butter lettuce leaves	butter lettuce leaves	1
diagonally sliced celery	diagonally sliced celery	1
kraft mayo	kraft mayo	1
white fish fillets	white fish fillets	1
lg. shrimp	lg . shrimp	1
lowmilk	lowmilk	1
jelly beans	jelly beans	1
tamarind juice	tamarind juice	1
tl	tl	1
lemon lime beverage	lemon lime beverage	1
flax egg	flax egg	1
ground round	ground round	1
finely peeled fresh ginger	finely peeled fresh ginger	1
equal sweetener	equal sweetener	1
g hackfleisch	g hackfleisch	1
milk half-and-half	milk half-and-half	1
black walnut	black walnut	1
liquid pectin	liquid pectin	1
cannellini beans beans	cannellini beans beans	1
semi-dried tomatoes	semi-dried tomatoes	1
layer	layer	1
strawberry syrup	strawberry syrup	1
ea for 3.49	ea for 3.49	1
beef beef	beef beef	1
spearmint	spearmint	1
turkey ham	turkey ham	1
copyright 2001 television food network	copyright 2001 television food network	1
chocolate pie crust	chocolate pie crust	1
pt. oysters	pt . oysters	1
spice	spice	1
scotch bonnet pepper	scotch bonnet pepper	1
black cherries	black cherries	1
pretzel	pretzel	1
cavatappi	cavatappi	1
strawberry ice cream	strawberry ice cream	1
canola oil vegetable oil	canola oil vegetable oil	1
craft knife	craft knife	1
cognac brandy	cognac brandy	1
equal	equal	1
red cayenne pepper	red cayenne pepper	1
caster	caster	1
ml yoghurt	ml yoghurt	1
lime juice lime	lime juice lime	1
eagle milk	eagle milk	1
cream of broccoli soup	cream of broccoli soup	1
cooked chicken	cooked chicken	1
certo	certo	1
turkey legs	turkey legs	1
vinaigrette:	vinaigrette :	1
pepperidge farm stuffing	pepperidge farm stuffing	1
hot roll mix	hot roll mix	1
garlic bread	garlic bread	1
italian herbs	italian herbs	1
chicken:	chicken :	1
bay leaf large	bay leaf large	1
tostadas	tostadas	1
millet flour	millet flour	1
glue	glue	1
hershey bar	hershey bar	1
lamb stew meat	lamb stew meat	1
beef ribs	beef ribs	1
tamarind concentrate	tamarind concentrate	1
cauliflower floret	cauliflower floret	1
pigeon peas	pigeon peas	1
. ground meat	. ground meat	1
kidney bean	kidney bean	1
fresh grapefruit juice	fresh grapefruit juice	1
ponzu	ponzu	1
stove top stuffing mix	stove top stuffing mix	1
cool whip topping	cool whip topping	1
london broil	london broil	1
artichoke hearts, drained	artichoke hearts , drained	1
cream-style cottage cheese	cream-style cottage cheese	1
bitter chocolate	bitter chocolate	1
pie crust mix	pie crust mix	1
milk yoghurt	milk yoghurt	1
bag caramels	bag caramels	1
bund lauchzwiebeln	bund lauchzwiebeln	1
bone broth	bone broth	1
mccormick's montreal brand steak seasoning	mccormick 's montreal brand steak seasoning	1
semi-sweet chocolate bits	semi-sweet chocolate bits	1
orange cake mix	orange cake mix	1
maraschino liqueur	maraschino liqueur	1
snap peas	snap peas	1
vegetables oil	vegetables oil	1
curls	curls	1
carob chips	carob chips	1
burgundy	burgundy	1
spaghetti cooked	spaghetti cooked	1
beef cubes	beef cubes	1
your choice	your choice	1
pumpkin spice	pumpkin spice	1
sweet green pepper	sweet green pepper	1
tiny marshmallows	tiny marshmallows	1
lager	lager	1
filo dough	filo dough	1
el senf	el senf	1
chicken breasts boneless	chicken breasts boneless	1
chicken breasts chicken	chicken breasts chicken	1
pimenton	pimenton	1
short rib	short rib	1
blackening seasoning	blackening seasoning	1
liquid aminos	liquid aminos	1
chervil leaves	chervil leaves	1
buffalo wing sauce	buffalo wing sauce	1
puy lentils	puy lentils	1
21/4 active dry yeast	21 / 4 active dry yeast	1
thick cream	thick cream	1
. spareribs	. spareribs	1
caraway	caraway	1
jar alfredo sauce	jar alfredo sauce	1
cilantro root	cilantro root	1
fine noodles	fine noodles	1
all purpose greek seasoning	all purpose greek seasoning	1
microgreens	microgreens	1
plum jam	plum jam	1
instant couscous	instant couscous	1
chinese sausage	chinese sausage	1
amaranth	amaranth	1
bacardi dark rum	bacardi dark rum	1
wondra flour	wondra flour	1
hot dog bun	hot dog bun	1
bits	bits	1
fren mixed vegetables	fren mixed vegetables	1
vegan butter	vegan butter	1
cooking	cooking	1
ml honey	ml honey	1
sweet white wine	sweet white wine	1
schalotten	schalotten	1
fresh flat leaf parsley	fresh flat leaf parsley	1
foie gras	foie gras	1
gr boter	gr boter	1
colored sprinkles	colored sprinkles	1
optional:	optional :	1
pancake	pancake	1
kefir	kefir	1
halibut steak	halibut steak	1
rustic bread	rustic bread	1
scheiben	scheiben	1
8 cream cheese	8 cream cheese	1
extra-virgin olive oil	extra-virgin olive oil	1
paprikapulver	paprikapulver	1
lg. chocolate chips	lg . chocolate chips	1
asparagus spear	asparagus spear	1
black salt	black salt	1
m & m's	m & m 's	1
chocolate extract	chocolate extract	1
parsley cilantro	parsley cilantro	1
chocolate morsel	chocolate morsel	1
green beans beans	green beans beans	1
ruby red grapefruit	ruby red grapefruit	1
baker's chocolate	baker 's chocolate	1
chipotle sauce	chipotle sauce	1
11/2 russet potatoes	11 / 2 russet potatoes	1
ragu	ragu	1
mehl fã¼r die arbeitsflã¤che	mehl fã1 ⁄ 4 r die arbeitsflã ¤ che	1
inches flour tortillas	inches flour tortillas	1
chilli paste	chilli paste	1
table cream	table cream	1
banana chips	banana chips	1
shredded jack cheese	shredded jack cheese	1
pt blackberries	pt blackberries	1
mixed salad leaves, to serve	mixed salad leaves , to serve	1
can black olives	can black olives	1
creamed horseradish	creamed horseradish	1
malt syrup	malt syrup	1
loin	loin	1
muesli	muesli	1
quail eggs	quail eggs	1
pita	pita	1
nam pla	nam pla	1
nacho chips	nacho chips	1
vine ripened tomatoes	vine ripened tomatoes	1
fluid water	fluid water	1
sweet onion large	sweet onion large	1
pearl tapioca	pearl tapioca	1
matzo cake meal	matzo cake meal	1
lamb stock	lamb stock	1
crema mexican	crema mexican	1
salz pfeffer	salz pfeffer	1
pizza cheese	pizza cheese	1
sichuan peppercorns	sichuan peppercorns	1
el essig	el essig	1
cream chicken soup	cream chicken soup	1
persimmon	persimmon	1
okra pods	okra pods	1
citrus	citrus	1
bananas sliced	bananas sliced	1
. tomatoes	. tomatoes	1
turkey tenderloins	turkey tenderloins	1
. fren hash browns	. fren hash browns	1
cream of celery	cream of celery	1
candy melts	candy melts	1
pistachio nut	pistachio nut	1
rutabagas	rutabagas	1
layer:	layer :	1
cream cheese spread	cream cheese spread	1
chicken stock vegetable stock	chicken stock vegetable stock	1
roux	roux	1
cocoa butter	cocoa butter	1
pineapple and juice	pineapple and juice	1
egg bread	egg bread	1
vanilla soymilk	vanilla soymilk	1
gelatin lemon	gelatin lemon	1
sliced pepperoni	sliced pepperoni	1
szechuan peppercorns	szechuan peppercorns	1
rock shrimp	rock shrimp	1
cheese crackers	cheese crackers	1
chocolate graham cracker crumbs	chocolate graham cracker crumbs	1
farina	farina	1
stick margarine	stick margarine	1
orange slice	orange slice	1
hokkien noodles	hokkien noodles	1
crumbled feta cheese	crumbled feta cheese	1
persian cucumber	persian cucumber	1
marmite	marmite	1
med onion	med onion	1
rice stick noodles	rice stick noodles	1
anise oil	anise oil	1
lemon balm	lemon balm	1
new york strip steaks	new york strip steaks	1
steel oats	steel oats	1
pkgs. dream whip	pkgs . dream whip	1
rosã© wine	rosã © wine	1
bulgar wheat	bulgar wheat	1
realemon juice	realemon juice	1
ea for 0.99	ea for 0.99	1
soup water	soup water	1
ml red wine vinegar	ml red wine vinegar	1
instant tapioca	instant tapioca	1
jar picante sauce	jar picante sauce	1
salt and pepper, to taste	salt and pepper , to taste	1
devils food cake mix	devils food cake mix	1
cinnamon cinnamon	cinnamon cinnamon	1
beef round	beef round	1
bag semi-sweet chocolate chips	bag semi-sweet chocolate chips	1
cream sauce	cream sauce	1
dark raisin	dark raisin	1
pork spare ribs	pork spare ribs	1
white quinoa	white quinoa	1
tia maria	tia maria	1
sugar brown sugar	sugar brown sugar	1
milk yogurt	milk yogurt	1
brown mushroom	brown mushroom	1
unbeaten eggs	unbeaten eggs	1
black mushrooms	black mushrooms	1
raspberry sauce	raspberry sauce	1
cabernet sauvignon	cabernet sauvignon	1
sunflower seed butter	sunflower seed butter	1
yellow rice	yellow rice	1
karotte	karotte	1
cooked, diced chicken	cooked , diced chicken	1
hass avocadoes	hass avocadoes	1
olive tapenade	olive tapenade	1
oyster	oyster	1
bacon bacon	bacon bacon	1
coconut milk yogurt	coconut milk yogurt	1
sundried tomatoes	sundried tomatoes	1
sesame oil oil	sesame oil oil	1
baby clams	baby clams	1
55g caster sugar	55 g caster sugar	1
vinegar juice	vinegar juice	1
fresh garlic	fresh garlic	1
bread and butter pickles	bread and butter pickles	1
baby eggplants	baby eggplants	1
graham wafer crumbs	graham wafer crumbs	1
duncan hines butter cake mix	duncan hines butter cake mix	1
italian	italian	1
gold medalâ® all-purpose flour	gold medalâ ® all-purpose flour	1
cheesecloth	cheesecloth	1
chicken flavor stuffing mix	chicken flavor stuffing mix	1
hershey's chocolate syrup	hershey 's chocolate syrup	1
red sockeye	red sockeye	1
chicken breast strips	chicken breast strips	1
garlic flakes	garlic flakes	1
stiele thymian	stiele thymian	1
brown sugar substitute	brown sugar substitute	1
lg. vanilla pudding	lg . vanilla pudding	1
curry leaf	curry leaf	1
natural yogurt	natural yogurt	1
egg beaters egg substitute	egg beaters egg substitute	1
for 2.69	for 2.69	1
ml white wine vinegar	ml white wine vinegar	1
kasuri methi	kasuri methi	1
thai sweet chili sauce	thai sweet chili sauce	1
tapenade	tapenade	1
grape	grape	1
el petersilie	el petersilie	1
strawberry extract	strawberry extract	1
red bell pepper strips	red bell pepper strips	1
orange soda	orange soda	1
env. gelatin	env . gelatin	1
brown mushrooms	brown mushrooms	1
anaheim chilies	anaheim chilies	1
unsulfured molasses	unsulfured molasses	1
sherry vinegar vinegar	sherry vinegar vinegar	1
black truffles	black truffles	1
bars	bars	1
can tomatoes	can tomatoes	1
broad beans	broad beans	1
:	:	1
sweet bell pepper	sweet bell pepper	1
dark muscovado sugar	dark muscovado sugar	1
romano	romano	1
worchestershire sauce	worchestershire sauce	1
181/4 devil's food cake mix	181 / 4 devil 's food cake mix	1
kahlãºa	kahlãoa	1
env onion soup mix	env onion soup mix	1
ruler	ruler	1
yellow miso	yellow miso	1
vanilla caramels	vanilla caramels	1
russet potatoes medium	russet potatoes medium	1
lg. angel food cake	lg . angel food cake	1
pt. sour cream	pt . sour cream	1
btl red wine	btl red wine	1
vermicelli noodles	vermicelli noodles	1
orange-flavored liqueur	orange-flavored liqueur	1
almonds almonds	almonds almonds	1
peach slices	peach slices	1
italian seasonings	italian seasonings	1
chicken seasoning	chicken seasoning	1
fren banana	fren banana	1
green sweet pepper	green sweet pepper	1
sea salt & black pepper	sea salt & black pepper	1
peel	peel	1
capellini	capellini	1
potato gnocchi	potato gnocchi	1
coconut chips	coconut chips	1
chinese egg noodles	chinese egg noodles	1
mixed pickling spices	mixed pickling spices	1
flaxseed oil	flaxseed oil	1
karo corn syrup	karo corn syrup	1
rice-wine vinegar	rice-wine vinegar	1
almonds sliced	almonds sliced	1
chanterelle	chanterelle	1
cooked white rice	cooked white rice	1
pkg	pkg	1
100g butter	100 g butter	1
wheat crackers	wheat crackers	1
cookie dough	cookie dough	1
vanilla custard	vanilla custard	1
tablespoons sugar	tablespoons sugar	1
red grapefruit	red grapefruit	1
crumbled goat cheese	crumbled goat cheese	1
turkey breast tenderloins	turkey breast tenderloins	1
black treacle	black treacle	1
medium bell pepper	medium bell pepper	1
unsalted sunflower seeds	unsalted sunflower seeds	1
glutinous rice	glutinous rice	1
chuck steaks	chuck steaks	1
kg chicken	kg chicken	1
teen knoflook	teen knoflook	1
petersilie	petersilie	1
hamburger patties	hamburger patties	1
turkish bay leaves	turkish bay leaves	1
dried lentils	dried lentils	1
. cream cheese	. cream cheese	1
11/2 cream of tartar	11 / 2 cream of tartar	1
vegetable stock powder	vegetable stock powder	1
italian breadcrumbs	italian breadcrumbs	1
jalapeã±o chili	jalapeã ± o chili	1
carrots sliced	carrots sliced	1
olive oil mayonnaise	olive oil mayonnaise	1
black eyed peas	black eyed peas	1
t parsley	t parsley	1
bermuda onion	bermuda onion	1
sherbet	sherbet	1
butterscotch schnapps	butterscotch schnapps	1
lamb mince	lamb mince	1
peanut oil vegetable oil	peanut oil vegetable oil	1
flowers	flowers	1
curly parsley	curly parsley	1
50g butter	50 g butter	1
salt and cracked black pepper	salt and cracked black pepper	1
dark red kidney beans	dark red kidney beans	1
g mascarpone	g mascarpone	1
yellow hominy	yellow hominy	1
crushed cornflakes	crushed cornflakes	1
eggwhites	eggwhites	1
shredded mzarella	shredded mzarella	1
. turkey	. turkey	1
heinz tomato ketchup	heinz tomato ketchup	1
coarse sugar	coarse sugar	1
carrot sticks	carrot sticks	1
sugar snap pea	sugar snap pea	1
corn oil butter	corn oil butter	1
for the crust:	for the crust :	1
unsweetened dutch process cocoa	unsweetened dutch process cocoa	1
ancho chilies	ancho chilies	1
bar chocolate	bar chocolate	1
ml schlagobers	ml schlagobers	1
curly kale	curly kale	1
agar	agar	1
bean threads	bean threads	1
piecrusts	piecrusts	1
nonfat yogurt	nonfat yogurt	1
red kidnei beans	red kidnei beans	1
veg. oil	veg . oil	1
all-purpose baking mix	all-purpose baking mix	1
fryer chicken	fryer chicken	1
stir fry sauce	stir fry sauce	1
streusel topping	streusel topping	1
a-1 steak sauce	a- 1 steak sauce	1
haddock fillets	haddock fillets	1
cod fish fillets	cod fish fillets	1
house seasoning	house seasoning	1
poundcake	poundcake	1
can cream of chicken	can cream of chicken	1
. flour	. flour	1
waffle	waffle	1
california avocado	california avocado	1
tuna oil	tuna oil	1
aged balsamic vinegar	aged balsamic vinegar	1
french baguettes	french baguettes	1
jamaican rum	jamaican rum	1
soya bean	soya bean	1
walnut meats	walnut meats	1
ready-to-use graham cracker crumb crust	ready-to-use graham cracker crumb crust	1
soybeans	soybeans	1
chablis	chablis	1
crostini	crostini	1
kraft shredded sharp cheddar cheese	kraft shredded sharp cheddar cheese	1
currants raisins	currants raisins	1
green pepper rings	green pepper rings	1
passionfruit	passionfruit	1
baby red potatoes	baby red potatoes	1
chicken strips	chicken strips	1
brussel sprouts	brussel sprouts	1
butterfinger candy bars	butterfinger candy bars	1
dutch cocoa	dutch cocoa	1
oscar mayer real bacon bits	oscar mayer real bacon bits	1
blueberry jam	blueberry jam	1
season	season	1
filet mignon	filet mignon	1
butter pecan ice cream	butter pecan ice cream	1
chat masala	chat masala	1
sweet soy sauce	sweet soy sauce	1
lg. garlic	lg . garlic	1
sweet cream butter	sweet cream butter	1
quick cooking rolled oats	quick cooking rolled oats	1
raw potatoes	raw potatoes	1
herbs mixed	herbs mixed	1
french green beans	french green beans	1
veal shoulder	veal shoulder	1
t. salt	t. salt	1
doughs	doughs	1
eschalots	eschalots	1
sweet-and-sour mix	sweet-and-sour mix	1
fried bacon	fried bacon	1
red sweet pepper	red sweet pepper	1
sauterne	sauterne	1
strawberry cake mix	strawberry cake mix	1
211/2 cream of chicken soup	211 / 2 cream of chicken soup	1
g puderzucker	g puderzucker	1
mittelgroãe zwiebel	mittelgroã  e zwiebel	1
butter-flavored cooking spray	butter-flavored cooking spray	1
rotini pasta	rotini pasta	1
141/2 black beans	141 / 2 black beans	1
leaf oregano	leaf oregano	1
wrap foil	wrap foil	1
special	special	1
beef top round steak	beef top round steak	1
spaghetti dried	spaghetti dried	1
glass noodles	glass noodles	1
vertically sliced red onion	vertically sliced red onion	1
yams potatoes	yams potatoes	1
stiele petersilie	stiele petersilie	1
ml beer	ml beer	1
sq. semi-sweet chocolate	sq . semi-sweet chocolate	1
breakstone's reduced	breakstone 's reduced	1
hawaiian punch	hawaiian punch	1
dry white wine chicken broth	dry white wine chicken broth	1
fritos corn chips	fritos corn chips	1
vine-ripened tomatoes	vine-ripened tomatoes	1
enokitake	enokitake	1
halibut steaks	halibut steaks	1
oregano flakes	oregano flakes	1
granny apples	granny apples	1
yellow cheese	yellow cheese	1
g zucchini	g zucchini	1
dry rub	dry rub	1
mint chocolate chip ice cream	mint chocolate chip ice cream	1
apple cider apple juice	apple cider apple juice	1
box strawberry jello	box strawberry jello	1
eggs egg egg the ultimate convenience food	eggs egg egg the ultimate convenience food	1
cashew	cashew	1
butter cookies	butter cookies	1
hard rolls	hard rolls	1
gruyã¨re	gruyã ̈re	1
hard cider	hard cider	1
nectar	nectar	1
low-fat yogurt	low-fat yogurt	1
dry marsala	dry marsala	1
mild sausage	mild sausage	1
pã¤ckchen vanillin-zucker	pã ¤ ckchen vanillin-zucker	1
yellow capsicum	yellow capsicum	1
g nudeln	g nudeln	1
sprig	sprig	1
white shoepeg corn	white shoepeg corn	1
buttery spread	buttery spread	1
red hot sauce	red hot sauce	1
sugar cookie dough	sugar cookie dough	1
salatgurke	salatgurke	1
monterey jack cheese shredded	monterey jack cheese shredded	1
hothouse cucumber	hothouse cucumber	1
regular rice	regular rice	1
turkey breasts	turkey breasts	1
monterey jack and cheddar cheese blend	monterey jack and cheddar cheese blend	1
sheet nori	sheet nori	1
chilli	chilli	1
wood chips	wood chips	1
pumpkin pie mix	pumpkin pie mix	1
ice cream cones	ice cream cones	1
grana padano	grana padano	1
pkg onion soup mix	pkg onion soup mix	1
hunts tomato sauce	hunts tomato sauce	1
campbell's tomato soup	campbell 's tomato soup	1
mint leaves mint	mint leaves mint	1
bison	bison	1
green food color	green food color	1
green cardamoms	green cardamoms	1
cornflakes cereal	cornflakes cereal	1
jar cheese whiz	jar cheese whiz	1
pistachio	pistachio	1
dry marsala wine	dry marsala wine	1
mixed baby greens	mixed baby greens	1
romano cheese cheese	romano cheese cheese	1
sirloin tip roast	sirloin tip roast	1
bund dill	bund dill	1
cabbage shredded	cabbage shredded	1
21/2 baking soda	21 / 2 baking soda	1
truffles	truffles	1
quick cooking oatmeal	quick cooking oatmeal	1
x cayenne pepper	x cayenne pepper	1
haricots verts beans	haricots verts beans	1
buttered crumbs	buttered crumbs	1
salt and ground black pepper	salt and ground black pepper	1
strawberry purã©e	strawberry purã © e	1
yellow beans	yellow beans	1
creme de cassis	creme de cassis	1
bucatini	bucatini	1
ml rotwein	ml rotwein	1
whole wheat bread crumbs	whole wheat bread crumbs	1
toffee pieces	toffee pieces	1
konbu	konbu	1
campbell's real stock beef	campbell 's real stock beef	1
miniature chocolate chips	miniature chocolate chips	1
bag tortilla chips	bag tortilla chips	1
fã¼r die sauce:	fã1 ⁄ 4 r die sauce :	1
sweet gherkin	sweet gherkin	1
ml balsamic vinegar	ml balsamic vinegar	1
water skewers	water skewers	1
eetlepels olie	eetlepels olie	1
beef stock prefer veal stock if possible	beef stock prefer veal stock if possible	1
carnation evaporated milk	carnation evaporated milk	1
fiber one cereal	fiber one cereal	1
celery soup, undiluted	celery soup , undiluted	1
burgers	burgers	1
annatto seeds	annatto seeds	1
corn bread mix	corn bread mix	1
lg. bell peppers	lg . bell peppers	1
raspberry sorbet	raspberry sorbet	1
farfalle	farfalle	1
ml weiãwein	ml weiã  wein	1
mexican chocolate	mexican chocolate	1
cooked squash	cooked squash	1
inches ginger	inches ginger	1
lemon verbena	lemon verbena	1
cakes yeast	cakes yeast	1
toppings:	toppings :	1
lite soy sauce	lite soy sauce	1
peppermint candies	peppermint candies	1
italian seasoning mix	italian seasoning mix	1
mittelgroãe zwiebeln	mittelgroã  e zwiebeln	1
fren puff pastry sheets	fren puff pastry sheets	1
natural cocoa	natural cocoa	1
broccoli cheese soup	broccoli cheese soup	1
brioche buns	brioche buns	1
tostada shells	tostada shells	1
maca powder	maca powder	1
string	string	1
water water	water water	1
soup mix	soup mix	1
cabbage cabbage	cabbage cabbage	1
vegetable bouillon cubes	vegetable bouillon cubes	1
pkt.	pkt .	1
orange flavoring	orange flavoring	1
lollipop	lollipop	1
pepper and salt	pepper and salt	1
baking apples	baking apples	1
chai tea	chai tea	1
brown sugar sugar	brown sugar sugar	1
cool whip lite	cool whip lite	1
five spice	5 spice	1
marinated artichokes	marinated artichokes	1
dry wine	dry wine	1
prosciutto di parma	prosciutto di parma	1
soy protein	soy protein	1
cornmeal yellow	cornmeal yellow	1
spaghetti sauce mix	spaghetti sauce mix	1
x white pepper	x white pepper	1
red vinegar	red vinegar	1
dry parsley	dry parsley	1
komkommer	komkommer	1
bund basilikum	bund basilikum	1
ahi	ahi	1
light agave nectar	light agave nectar	1
garlic juice	garlic juice	1
edelsã¼ã-paprika	edelsã1 ⁄ 4 ã  -paprika	1
plum tomatoes tomatoes	plum tomatoes tomatoes	1
kikkoman soy sauce	kikkoman soy sauce	1
s&p	s & p	1
salt water	salt water	1
pea	pea	1
white breadcrumbs	white breadcrumbs	1
tamari sauce	tamari sauce	1
cheese blend	cheese blend	1
craft glue	craft glue	1
11/2 skirt steak	11 / 2 skirt steak	1
pork chop	pork chop	1
lemon supreme cake mix	lemon supreme cake mix	1
mehl	mehl	1
eagle brand	eagle brand	1
salmon roe	salmon roe	1
green shallots	green shallots	1
skewer	skewer	1
pineapple crushed	pineapple crushed	1
balsamic vinegar vinegar	balsamic vinegar vinegar	1
horseradish root	horseradish root	1
white bread dough	white bread dough	1
whisky	whisky	1
turkey sausage links	turkey sausage links	1
vine tomatoes	vine tomatoes	1
31/2 pudding mix	31 / 2 pudding mix	1
mature cheddar	mature cheddar	1
instant chicken bouillon granules	instant chicken bouillon granules	1
red pepper hot sauce	red pepper hot sauce	1
t garlic	t garlic	1
grand marnier orange liqueur	grand marnier orange liqueur	1
ml rum	ml rum	1
tomato slices	tomato slices	1
11/2 round steaks	11 / 2 round steaks	1
crumbles	crumbles	1
carton commercial sour cream	carton commercial sour cream	1
absinthe	absinthe	1
salad leaves, to serve	salad leaves , to serve	1
for the dressing:	for the dressing :	1
presliced mushrooms	presliced mushrooms	1
pkg taco seasoning mix	pkg taco seasoning mix	1
codfish	codfish	1
dry pinto beans	dry pinto beans	1
pitted dates	pitted dates	1
wheat lasagna noodles	wheat lasagna noodles	1
olive oil-flavored cooking spray	olive oil-flavored cooking spray	1
chã¨vre	chã ̈vre	1
cakes:	cakes :	1
pumpkinseeds	pumpkinseeds	1
eggs egg substitute	eggs egg substitute	1
chicken soup, undiluted	chicken soup , undiluted	1
focaccia bread	focaccia bread	1
dried leaf thyme	dried leaf thyme	1
snipped chives	snipped chives	1
italian rolls	italian rolls	1
bread mix	bread mix	1
veal scallops	veal scallops	1
mushroom soup, undiluted	mushroom soup , undiluted	1
for the cake:	for the cake :	1
pot double cream	pot double cream	1
almond meal almonds	almond meal almonds	1
yellow tomatoes	yellow tomatoes	1
butter pecan cake mix	butter pecan cake mix	1
buckwheat	buckwheat	1
basil leaves basil	basil leaves basil	1
chicken breasts chicken thighs	chicken breasts chicken thighs	1
lime wedges optional	lime wedges optional	1
lamb rib chops	lamb rib chops	1
basil leaves large	basil leaves large	1
white fish	white fish	1
asian pear	asian pear	1
fren pink lemonade	fren pink lemonade	1
honey graham crackers	honey graham crackers	1
maple-flavored syrup	maple-flavored syrup	1
watercress sprigs	watercress sprigs	1
quinoa cooked	quinoa cooked	1
olives oil	olives oil	1
raspberry juice	raspberry juice	1
bar paraffin	bar paraffin	1
proscuitto	proscuitto	1
farfalle pasta	farfalle pasta	1
mushroom broth	mushroom broth	1
masa	masa	1
buttered bread crumbs	buttered bread crumbs	1
linguine pasta	linguine pasta	1
scallions onion	scallions onion	1
crescent dinner rolls	crescent dinner rolls	1
cornmeal mix	cornmeal mix	1
mini-marshmallows	mini-marshmallows	1
bund suppengrã¼n	bund suppengrã1 ⁄ 4 n	1
poppy seed dressing	poppy seed dressing	1
green papaya	green papaya	1
boneless pork shoulder	boneless pork shoulder	1
granny apple	granny apple	1
strawberry glaze	strawberry glaze	1
graham	graham	1
cooked sweet potatoes	cooked sweet potatoes	1
aacore	aacore	1
cranberry beans	cranberry beans	1
oreo cookie crumbs	oreo cookie crumbs	1
loaves bread	loaves bread	1
corn beef	corn beef	1
serrano chili	serrano chili	1
ml slagroom	ml slagroom	1
coconut shredded	coconut shredded	1
thymian	thymian	1
camembert	camembert	1
blatt gelatine	blatt gelatine	1
jumbo shells	jumbo shells	1
zitronensaft	zitronensaft	1
can chickpeas	can chickpeas	1
raspberry puree	raspberry puree	1
red	red	1
dry ranch dressing mix	dry ranch dressing mix	1
sugar sugar substitute	sugar sugar substitute	1
g speck	g speck	1
hass avocados	hass avocados	1
heinz 57 sauce	heinz 57 sauce	1
half & half cream	half & half cream	1
rainbow trout	rainbow trout	1
chicken carcass	chicken carcass	1
jar taco sauce	jar taco sauce	1
alfalfa sprout	alfalfa sprout	1
red tomatoes	red tomatoes	1
country white bread	country white bread	1
water chicken broth	water chicken broth	1
splenda sugar blend	splenda sugar blend	1
vegan cream cheese	vegan cream cheese	1
slivered almonds	slivered almonds	1
morels	morels	1
hash brown	hash brown	1
g gemischtes hackfleisch	g gemischtes hackfleisch	1
maggi	maggi	1
fruit preserves	fruit preserves	1
2% reduced-fat milk	2 % reduced-fat milk	1
peach jam	peach jam	1
fig preserves	fig preserves	1
matcha	matcha	1
lg. oreo cookies	lg . oreo cookies	1
garlic shoots	garlic shoots	1
g tomaten	g tomaten	1
arborio rice rice	arborio rice rice	1
duck legs	duck legs	1
liter ginger ale	liter ginger ale	1
gingerale	gingerale	1
smoked gouda cheese	smoked gouda cheese	1
cherry tomato	cherry tomato	1
andouille sausages	andouille sausages	1
skinned chicken breast halves	skinned chicken breast halves	1
. pork	. pork	1
egg eggs	egg eggs	1
rib-eye steaks	rib-eye steaks	1
cauliflower flowerets	cauliflower flowerets	1
dri leav rosemari	dri leav rosemari	1
self raising flour	self raising flour	1
kombu	kombu	1
lemon sherbet	lemon sherbet	1
florets	florets	1
pizza seasoning	pizza seasoning	1
smoked haddock	smoked haddock	1
chocolate mix	chocolate mix	1
chocolate icing	chocolate icing	1
jimmy dean sausage	jimmy dean sausage	1
tl ãl	tl ã  l	1
white grapes	white grapes	1
lemon sorbet	lemon sorbet	1
spread	spread	1
garni	garni	1
hidden valley ranch dressing	hidden valley ranch dressing	1
mixed beans	mixed beans	1
browning sauce	browning sauce	1
chicken stock powder	chicken stock powder	1
cornflake cereal	cornflake cereal	1
chicken gumbo soup	chicken gumbo soup	1
less than 1/8 salt	less than 1 / 8 salt	1
kg potatoes	kg potatoes	1
chicken mince	chicken mince	1
sponge	sponge	1
shredded cheddar	shredded cheddar	1
condensed cream of mushroom soup, undiluted	condensed cream of mushroom soup , undiluted	1
petersilie zum garnieren	petersilie zum garnieren	1
caramel candies	caramel candies	1
poblano chile	poblano chile	1
coconut meat	coconut meat	1
aubergines	aubergines	1
60ml 1/4 olive oil	60 ml 1 / 4 olive oil	1
11/2 sweet potatoes	11 / 2 sweet potatoes	1
crã¨me de cassis	crã ̈me de cassis	1
hidden valley ranch dressing mix	hidden valley ranch dressing mix	1
pkgs. strawberry jello	pkgs . strawberry jello	1
fat-free	fat-free	1
wax paper	wax paper	1
. butter	. butter	1
arrowroot flour	arrowroot flour	1
italian-seasoned breadcrumbs	italian-seasoned breadcrumbs	1
chocolate ganache	chocolate ganache	1
stange/n lauch	stange / n lauch	1
tuna steak	tuna steak	1
pear tomatoes	pear tomatoes	1
lg. banana	lg . banana	1
raisins cranberries	raisins cranberries	1
mayonnaise mayonnaise	mayonnaise mayonnaise	1
lime lemon	lime lemon	1
realemon lemon juice	realemon lemon juice	1
cooked eow macaroni	cooked eow macaroni	1
pkgs active dry yeast	pkgs active dry yeast	1
sweet red wine	sweet red wine	1
smith apples	smith apples	1
wheat bread crumbs	wheat bread crumbs	1
card stock	card stock	1
cachaca	cachaca	1
cardamom seed	cardamom seed	1
t water	t water	1
unsweetened chocolate	unsweetened chocolate	1
parsley leaves finely	parsley leaves finely	1
raisins dates	raisins dates	1
sticky rice	sticky rice	1
for the salad:	for the salad :	1
swiss cheese shredded	swiss cheese shredded	1
tomatoes ripe	tomatoes ripe	1
pt. cherry tomatoes	pt . cherry tomatoes	1
large marshmallows	large marshmallows	1
coffee cream	coffee cream	1
oil tomatoes	oil tomatoes	1
meatloaf	meatloaf	1
gluten-free tamari	gluten-free tamari	1
chicken gizzards	chicken gizzards	1
miracle whip light dressing	miracle whip light dressing	1
t olive oil	t olive oil	1
kraft zesty italian dressing	kraft zesty italian dressing	1
wheat buns	wheat buns	1
cans green chilies	cans green chilies	1
popsicle sticks	popsicle sticks	1
chocolate hazelnut spread	chocolate hazelnut spread	1
yam	yam	1
white wine vinegar vinegar	white wine vinegar vinegar	1
for 1.00	for 1	1
paste	paste	1
corn flakes cereal	corn flakes cereal	1
milch	milch	1
thai red curry paste	thai red curry paste	1
spring mix	spring mix	1
chicken breast meat	chicken breast meat	1
cilantro stem	cilantro stem	1
cuban peppers	cuban peppers	1
breast	breast	1
applejack	applejack	1
chicken broth salt	chicken broth salt	1
tomato pasta sauce	tomato pasta sauce	1
pumpkin butter	pumpkin butter	1
chile paste garlic	chile paste garlic	1
. chicken wings	. chicken wings	1
short pasta	short pasta	1
german chocolate	german chocolate	1
breadstick	breadstick	1
mint chocolate chips	mint chocolate chips	1
tenderloin	tenderloin	1
lg. can sliced peaches	lg . can sliced peaches	1
scalded milk	scalded milk	1
g speisestã¤rke	g speisestã ¤ rke	1
eggs water	eggs water	1
buttercake mix	buttercake mix	1
brandy extract	brandy extract	1
brown cardamom	brown cardamom	1
portabello mushroom large	portabello mushroom large	1
verde	verde	1
dumpling wrappers	dumpling wrappers	1
white beans beans	white beans beans	1
black	black	1
nutmegs	nutmegs	1
broiler-fryer	broiler-fryer	1
sewing machine	sewing machine	1
seltzer water	seltzer water	1
savory dried	savory dried	1
tiny peas	tiny peas	1
gumbo file	gumbo file	1
gl white wine	gl white wine	1
tonic water	tonic water	1
sour cream dairy	sour cream dairy	1
ml stock	ml stock	1
all bran	all bran	1
olive oil olive oil	olive oil olive oil	1
ml olivenã¶l	ml olivenã ¶ l	1
tea leaves	tea leaves	1
pisco	pisco	1
king arthur unbleached all-purpose flour	king arthur unbleached all-purpose flour	1
flavored syrup	flavored syrup	1
pale ale	pale ale	1
all purpose seasoning	all purpose seasoning	1
tl gemã¼sebrã¼he	tl gemã1 ⁄ 4 sebrã1 ⁄ 4 he	1
red pepper, cut into strips	red pepper , cut into strips	1
bun	bun	1
lardons	lardons	1
beef top sirloin steak	beef top sirloin steak	1
egg water	egg water	1
italian pork sausage	italian pork sausage	1
malibu rum	malibu rum	1
radish sprouts	radish sprouts	1
ragu spaghetti sauce	ragu spaghetti sauce	1
diced pimentos	diced pimentos	1
non-dairy margarine	non-dairy margarine	1
dutch process cocoa	dutch process cocoa	1
liters water	liters water	1
stewing chicken	stewing chicken	1
karo light corn syrup	karo light corn syrup	1
orange roughy	orange roughy	1
soy sauce soy sauce	soy sauce soy sauce	1
orange roughy fillets	orange roughy fillets	1
teaspoon salt	teaspoon salt	1
vanilla soy milk	vanilla soy milk	1
snow pea sprouts	snow pea sprouts	1
101/2 cream of celery soup	101 / 2 cream of celery soup	1
zucchini sliced	zucchini sliced	1
aacore tuna	aacore tuna	1
turkey pepperoni	turkey pepperoni	1
mushroom pieces	mushroom pieces	1
pineapple syrup	pineapple syrup	1
can cream of mushroom soup	can cream of mushroom soup	1
salsa:	salsa :	1
walnuts almonds	walnuts almonds	1
moroccan seasoning	moroccan seasoning	1
spicy sausage	spicy sausage	1
stack ritz crackers	stack ritz crackers	1
carrots carrot orange colour	carrots carrot orange colour	1
beef stock beef broth	beef stock beef broth	1
pork rind	pork rind	1
waffles	waffles	1
fã¼r den teig:	fã1 ⁄ 4 r den teig :	1
eetlepel olijfolie	eetlepel olijfolie	1
chocolate cookie	chocolate cookie	1
brown sugar light	brown sugar light	1
mutton	mutton	1
racks of lamb	racks of lamb	1
sour cream yogurt	sour cream yogurt	1
mahi mahi	mahi mahi	1
tomatoes tomato	tomatoes tomato	1
chardonnay wine	chardonnay wine	1
butter flavored shortening	butter flavored shortening	1
pt milk	pt milk	1
bartlett pear	bartlett pear	1
tbs flour	tbs flour	1
risotto	risotto	1
beef tenderloin steaks	beef tenderloin steaks	1
t. pepper	t. pepper	1
shiso leaves	shiso leaves	1
nori sheets	nori sheets	1
fronds	fronds	1
pork fillet	pork fillet	1
adobo	adobo	1
strawberry pie filling	strawberry pie filling	1
carrots grated	carrots grated	1
maxwell house instant coffee	maxwell house instant coffee	1
l milch	l milch	1
yeast cakes	yeast cakes	1
hershey syrup	hershey syrup	1
sweetcorn	sweetcorn	1
hershey's kisses	hershey 's kisses	1
raisins currants	raisins currants	1
hormel chili	hormel chili	1
corn kernels corn kernels	corn kernels corn kernels	1
malt powder	malt powder	1
t soy sauce	t soy sauce	1
campbell's cream of chicken soup	campbell 's cream of chicken soup	1
chocolate fudge topping	chocolate fudge topping	1
oscar mayer bacon, cooked, crumbled	oscar mayer bacon , cooked , crumbled	1
80ml olive oil	80 ml olive oil	1
cooking liquid	cooking liquid	1
ml melk	ml melk	1
twinkies	twinkies	1
bar cream cheese	bar cream cheese	1
strawberries strawberries	strawberries strawberries	1
eidotter	eidotter	1
chinese pea pods	chinese pea pods	1
crushed ritz crackers	crushed ritz crackers	1
english cheese spread	english cheese spread	1
wheels	wheels	1
1% low-fat cottage cheese	1 % low-fat cottage cheese	1
dried fettuccine	dried fettuccine	1
white vermouth	white vermouth	1
chicken and rice soup	chicken and rice soup	1
gluten free soy sauce	gluten free soy sauce	1
breadcrumbs bread crumbs	breadcrumbs bread crumbs	1
grote ui	grote ui	1
flour, all-purpose sifted	flour , all-purpose sifted	1
kidney beans beans	kidney beans beans	1
mzarella cheese cheese	mzarella cheese cheese	1
top whip	top whip	1
rashers bacon	rashers bacon	1
elderflower liqueur	elderflower liqueur	1
apples apple	apples apple	1
sourdough baguette	sourdough baguette	1
sazon goya	sazon goya	1
belgian endives	belgian endives	1
japanese eggplants	japanese eggplants	1
vegan worcestershire sauce	vegan worcestershire sauce	1
lg. sweet potatoes	lg . sweet potatoes	1
35% cream	35 % cream	1
bow tie pasta	bow tie pasta	1
cool water	cool water	1
yogurt cheese	yogurt cheese	1
chocolate cookies	chocolate cookies	1
red pepper large	red pepper large	1
knorr vegetable soup mix	knorr vegetable soup mix	1
chuck beef	chuck beef	1
60ml 1/4 lemon juice	60 ml 1 / 4 lemon juice	1
carton	carton	1
avocados - peeled	avocados - peeled	1
chihuahua cheese	chihuahua cheese	1
quick cooking rice	quick cooking rice	1
real lemon juice	real lemon juice	1
gooseberries	gooseberries	1
lemonade mix	lemonade mix	1
lg. bay leaf	lg . bay leaf	1
amaretti	amaretti	1
egg yolks at room temperature	egg yolks at room temperature	1
soba	soba	1
piecrust	piecrust	1
211/2 cream of mushroom soup	211 / 2 cream of mushroom soup	1
candied peel	candied peel	1
tl zitronensaft	tl zitronensaft	1
bechamel sauce	bechamel sauce	1
corn oil oil	corn oil oil	1
hibiscus flowers	hibiscus flowers	1
dried whole thyme	dried whole thyme	1
riesling	riesling	1
undiluted evaporated milk	undiluted evaporated milk	1
skirt steaks	skirt steaks	1
poblano chilies	poblano chilies	1
potato puree	potato puree	1
shitake mushrooms	shitake mushrooms	1
coffee flavor	coffee flavor	1
tandoori paste	tandoori paste	1
wheat cereal	wheat cereal	1
peach jello	peach jello	1
pimento-stuffed olives	pimento-stuffed olives	1
pork sausage links	pork sausage links	1
peanut butter butter	peanut butter butter	1
macaroons	macaroons	1
doughnuts	doughnuts	1
jar mushrooms	jar mushrooms	1
sure-jell	sure-jell	1
no-salt-added tomato sauce	no-salt-added tomato sauce	1
medium noodles	medium noodles	1
cream of mushroom chicken soup	cream of mushroom chicken soup	1
sweet smoked paprika	sweet smoked paprika	1
0.55 cream cheese	0.55 cream cheese	1
orange juice orange	orange juice orange	1
sunflower oil oil	sunflower oil oil	1
dill relish	dill relish	1
salt and cayenne pepper	salt and cayenne pepper	1
caper berries	caper berries	1
pasta noodles	pasta noodles	1
caesar salad dressing	caesar salad dressing	1
chestnut flour	chestnut flour	1
whole corn	whole corn	1
white onion large	white onion large	1
sure jell	sure jell	1
cabbage head	cabbage head	1
white granulated sugar	white granulated sugar	1
alcohol	alcohol	1
crumbled gorgonzola	crumbled gorgonzola	1
jack daniels	jack daniels	1
bechamel	bechamel	1
orange bell peppers	orange bell peppers	1
cream soup	cream soup	1
well-beaten eggs	well-beaten eggs	1
bar paraffin wax	bar paraffin wax	1
white cheddar	white cheddar	1
19 black beans	19 black beans	1
semisweet chocolate chips	semisweet chocolate chips	1
lg. red onion	lg . red onion	1
wheat english muffins	wheat english muffins	1
utility knife	utility knife	1
soya flour	soya flour	1
biscotti	biscotti	1
baked ham	baked ham	1
rode ui	rode ui	1
. onions	. onions	1
snickers	snickers	1
vegetable stock cube	vegetable stock cube	1
spinach fettuccine	spinach fettuccine	1
cooked diced chicken	cooked diced chicken	1
red pepper strips	red pepper strips	1
cassis	cassis	1
frã¼hlingszwiebel	frã1 ⁄ 4 hlingszwiebel	1
prepar pesto	prepar pesto	1
step 2:	step 2 :	1
mixture	mixture	1
nectarine	nectarine	1
brown ale	brown ale	1
leaf thyme	leaf thyme	1
roll ritz crackers	roll ritz crackers	1
lemon flavor	lemon flavor	1
boneless lamb	boneless lamb	1
sunflower kernels	sunflower kernels	1
large artichokes	large artichokes	1
flour, all purpose	flour , all purpose	1
ear corn	ear corn	1
103/4 condensed cheddar cheese soup	103 / 4 condensed cheddar cheese soup	1
beef lamb	beef lamb	1
all spice	all spice	1
center bacon	center bacon	1
morsels	morsels	1
serrano	serrano	1
egg milk	egg milk	1
lg. red pepper	lg . red pepper	1
g schinken	g schinken	1
bone folder	bone folder	1
hidden valleyâ® original ranchâ® dressing	hidden valleyâ ® original ranchâ ® dressing	1
grouper fillets	grouper fillets	1
glycerin	glycerin	1
chipotle paste	chipotle paste	1
gluten-free baking powder	gluten-free baking powder	1
sugar divided	sugar divided	1
low-sodium chicken broth stock	low-sodium chicken broth stock	1
batter:	batter :	1
t. flour	t. flour	1
unsalted margarine	unsalted margarine	1
packet onion soup mix	packet onion soup mix	1
confectionery sugar	confectionery sugar	1
60ml water	60 ml water	1
filtered water	filtered water	1
dry buttermilk	dry buttermilk	1
lg. box strawberry jello	lg . box strawberry jello	1
g spaghetti	g spaghetti	1
vegetable oil butter	vegetable oil butter	1
lg. tub cool whip	lg . tub cool whip	1
bay scallop	bay scallop	1
squash blossoms	squash blossoms	1
chinese black vinegar	chinese black vinegar	1
cilantro stems	cilantro stems	1
season salt	season salt	1
low-fat cream of mushroom soup	low-fat cream of mushroom soup	1
bag	bag	1
miracle whip light	miracle whip light	1
black sesame seed	black sesame seed	1
butternut	butternut	1
roquefort	roquefort	1
graham cracker pie crusts	graham cracker pie crusts	1
live lobsters	live lobsters	1
gravy master	gravy master	1
baby turnips	baby turnips	1
brewer's yeast	brewer 's yeast	1
eggs eggs	eggs eggs	1
cream quark	cream quark	1
kraft lite ranch dressing	kraft lite ranch dressing	1
29 stewed tomatoes	29 stewed tomatoes	1
can sliced black olives	can sliced black olives	1
passata	passata	1
green cherries	green cherries	1
white wine chicken broth	white wine chicken broth	1
grappa	grappa	1
radicchio leaves	radicchio leaves	1
french beans	french beans	1
turkish or 1/2 california bay leaf	turkish or 1 / 2 california bay leaf	1
salted nuts	salted nuts	1
pattypan squash	pattypan squash	1
for 2 crust pie	for 2 crust pie	1
fren cut green beans	fren cut green beans	1
dill pickle juice	dill pickle juice	1
x parsley leaves	x parsley leaves	1
saltine cracker crumbs	saltine cracker crumbs	1
puritan oil	puritan oil	1
duck sauce	duck sauce	1
chipotle chilies	chipotle chilies	1
powdered buttermilk	powdered buttermilk	1
jamaican jerk seasoning	jamaican jerk seasoning	1
fresh sliced mushrooms	fresh sliced mushrooms	1
mccormickâ® pure vanilla extract	mccormickâ ® pure vanilla extract	1
soppressata	soppressata	1
green cabbage, shredded	green cabbage , shredded	1
link sausage	link sausage	1
brown sugar packed	brown sugar packed	1
prepared mustard	prepared mustard	1
pinot noir	pinot noir	1
green zucchini	green zucchini	1
kieasa sausage	kieasa sausage	1
bratwursts	bratwursts	1
fresh fruit	fresh fruit	1
tomato chutney	tomato chutney	1
yellow tomato	yellow tomato	1
pork rib chops	pork rib chops	1
salad supreme	salad supreme	1
black forest ham	black forest ham	1
clam broth	clam broth	1
tomatoes diced	tomatoes diced	1
grape nuts	grape nuts	1
broken nuts	broken nuts	1
pandanus leaf	pandanus leaf	1
7-up soda	7 -up soda	1
wheat tortilla	wheat tortilla	1
. milk	. milk	1
t ginger	t ginger	1
pickapeppa sauce	pickapeppa sauce	1
tomatoes chilies	tomatoes chilies	1
artichoke bottoms	artichoke bottoms	1
dried fruit	dried fruit	1
gran marnier	gran marnier	1
cayenne red pepper	cayenne red pepper	1
clementine juice	clementine juice	1
club crackers	club crackers	1
fren orange juice	fren orange juice	1
21/2 russet potatoes	21 / 2 russet potatoes	1
saffron strands	saffron strands	1
sole fillets	sole fillets	1
tl speisestã¤rke	tl speisestã ¤ rke	1
coconut syrup	coconut syrup	1
rounded flour	rounded flour	1
dried split peas	dried split peas	1
g pinienkerne	g pinienkerne	1
adzuki beans	adzuki beans	1
mission figs	mission figs	1
nuts; optional	nuts ; optional	1
heavy cream whipping cream	heavy cream whipping cream	1
pepperoni turkei	pepperoni turkei	1
11/2 parmesan cheese	11 / 2 parmesan cheese	1
sunrice jasmine fragrant rice, to serve	sunrice jasmine fragrant rice , to serve	1
apricot juice	apricot juice	1
white bread bread	white bread bread	1
sofrito	sofrito	1
sure-jell fruit pectin	sure-jell fruit pectin	1
mint candies	mint candies	1
onions sliced	onions sliced	1
garbanzo bean flour	garbanzo bean flour	1
simply potatoes traditionalpotatoes	simply potatoes traditionalpotatoes	1
saigon cinnamon	saigon cinnamon	1
baby bella mushrooms	baby bella mushrooms	1
block cream cheese	block cream cheese	1
mcintosh apples	mcintosh apples	1
saltine crumbs	saltine crumbs	1
kg tomatoes	kg tomatoes	1
cutlet	cutlet	1
brown sauce	brown sauce	1
extra light olive oil	extra light olive oil	1
11/2 crushed red pepper flakes	11 / 2 crushed red pepper flakes	1
tape	tape	1
â	â	1
barbecue seasoning	barbecue seasoning	1
sparkling sugar	sparkling sugar	1
stone-ground mustard	stone-ground mustard	1
10 ounce	10 ounce	1
g vollmilch-joghurt	g vollmilch-joghurt	1
durkee french fried onions	durkee french fried onions	1
cracker pie crust	cracker pie crust	1
guava paste	guava paste	1
for the topping:	for the topping :	1
beef stock cube	beef stock cube	1
vegemite	vegemite	1
almond essence	almond essence	1
toasted almonds	toasted almonds	1
el weiãwein-essig	el weiã  wein-essig	1
rice vinegar vinegar	rice vinegar vinegar	1
apple juice cider	apple juice cider	1
golden rum	golden rum	1
schmaltz	schmaltz	1
ears corn	ears corn	1
focaccia	focaccia	1
cantaloupe balls	cantaloupe balls	1
sharp white cheddar cheese	sharp white cheddar cheese	1
turkey drippings	turkey drippings	1
creme fraiche sour cream	creme fraiche sour cream	1
mushroom pieces, drained	mushroom pieces , drained	1
lg. philadelphia cream cheese	lg . philadelphia cream cheese	1
flavored oil	flavored oil	1
bloody mary mix	bloody mary mix	1
yellow sweet pepper	yellow sweet pepper	1
prei	prei	1
bailey's irish cream	bailey 's irish cream	1
wing sauce	wing sauce	1
cream of wheat	cream of wheat	1
quick oats	quick oats	1
red grapefruit juice	red grapefruit juice	1
zucchini	zucchini	1
planters slivered almonds	planters slivered almonds	1
hot-glue gun	hot-glue gun	1
onion, sliced thinly	onion , sliced thinly	1
vanilla greek yogurt	vanilla greek yogurt	1
clover honey	clover honey	1
sweetened strawberries	sweetened strawberries	1
limette	limette	1
zesty italian dressing	zesty italian dressing	1
spike seasoning	spike seasoning	1
center cut bacon	center cut bacon	1
sugar chocolate	sugar chocolate	1
diced bell pepper	diced bell pepper	1
white asparagus	white asparagus	1
thread	thread	1
moong dal	moong dal	1
pak choi	pak choi	1
jalapeno juice	jalapeno juice	1
chicken stock	chicken stock	1
beef stock	beef stock	1
fish stock	fish stock	1
vegetable stock	vegetable stock	1
garlic cloves	garlic cloves	1
cumin	cumin	1
minced shallot	minced shallot	1
minced chives	minced chives	1
garlic powder	garlic powder	1
garlic flakes	garlic flakes	1
ginger	ginger	1
ground ginger	ground ginger	1
crystallized ginger	crystallized ginger	1
tumeric	tumeric	1
cardamom	cardamom	1
cinnamon	cinnamon	1
chili powder	chili powder	1
paprika	paprika	1
ancho powder	ancho powder	1
soy sauce	soy sauce	1
tamari sauce	tamari sauce	1
worcestershire sauce	worcestershire sauce	1
coconut aminos	coconut aminos	1
ramen noodles	ramen noodles	1
soba noodles	soba noodles	1
glass noodles	glass noodles	1
shirataki noodles	shirataki noodles	1
rice noodles	rice noodles	1
kelp noodles	kelp noodles	1
spaghetti	spaghetti	1
vermicelli	vermicelli	1
veggie noodles	veggie noodles	1
wonton noodles	wonton noodles	1
chow mein noodles	chow mein noodles	1
sliced fried pork	sliced fried pork	1
sliced fried chicken	sliced fried chicken	1
sliced chasu	sliced chasu	1
chashu	chashu	1
bonito flakes	bonito flakes	1
menma	menma	1
seaweed	seaweed	1
sliced green spring onions	sliced green spring onions	1
shallots	shallots	1
broth mix	broth mix	1
cooked broth	cooked broth	1
nori	nori	1
water	water	1
salt	salt	1
sugar	sugar	1
pepper	pepper	1
panko	panko	1
eggs	eggs	1
flour	flour	1
pork cutlets	pork cutlets	1
dried menma	dried menma	1
soy sauce	soy sauce	1
