wok	wok	1
grill pan	grill pan	1
sauce pan	sauce pan	1
saucier	saucier	1
double boiler	double boiler	1
multi pot	multi pot	1
braiser	braiser	1
french oven	french oven	1
dutch oven	dutch oven	1
deep skillet	deep skillet	1
roaster pan	roaster pan	1
stock pot	stock pot	1
soup pot	soup pot	1
microwave	microwave	1
bowl	bowl	1
knife	knife	1
spoon	spoon	1
measuring cups	measuring cups	1
wooden spoons	wooden spoons	1
whisk	whisk	1
colander	colander	1
chopsticks	chopsticks	1
forks	forks	1
